log	ell
nou	ces
vod	ces
stav	ces
graf	ell
kon	lat
ičk	ces
vol	ces
form	lat
man	ell
prav	ces
sed	ces
kop	ces
raz	ces
rod	ces
sad	ces
bal	eng
plat	ces
tk	ces
let	ces
ži	ces
bor	ces
věd	ces
pis	ces
sob	ces
ion	lat
zn	ces
kol	ces
pad	ces
svět	ces
děl	ces
hod	ces
klad	ces
stup	ces
d	ces
pust	ces
řad	ces
port	fra,lat
vaz	ces
kup	ces
lep	ces
ism	ell
mat	ces
fon	ell
hor	ces
hrad	ces
řez	ces
sou	ces
mal	deu
tele	ell
vel	ces
verz	lat
chod	ces
měn	ces
těž	ces
tisk	ces
váž	ces
nos	ces
bud	ces
střel	ces
jedn	ces
rost	ces
moc	ces
ps	ces
plav	ces
uč	ces
stroj	ces
čin	ces
hled	ces
fer	lat
lom	ces
pol	ces
zor	ces
sek	ces
váz	ces
metr	ell
par	lat
hoř	ces
m	ces
jem	ces
stat	ces
měr	ces
ruč	ces
rad	ces
střih	ces
trh	ces
bol	ces
met	ces
viz	deu,lat
nov	ces
kap	ces
leh	ces
lev	ces
maz	ces
mrz	ces
vrh	deu
stoup	ces
syp	ces
cykl	lat,ell
vin	ces
hub	ces
top	ces
pas	ces
mluv	ces
ryb	ces
tř	ces
zl	ces
jekt	lat
arch	lat,ell
pat	ell
gen	ell
ink	ces
bod	ces
cit	lat
čet	ces
ovk	ces
sam	ces
lid	ces
měst	ces
mil	ces
mysl	ces
sud	ces
pál	ces
toč	ces
skoč	ces
voz	ces
vrt	ces
běh	ces
prů	ces
by	ces
pon	lat
dob	ces
sta	ces
val	ces
káz	ces
lož	ces
moč	ces
rv	ces
stud	lat
trav	ces
vlast	ces
um	ces
soud	ces
škol	ces
šlap	ces
trp	ces
fil	ell
past	ces
roze	ces
ovit	ces
ven	ces
lež	ces
ped	ell
chov	ces
prim	lat
plet	ces
mot	ces
ze	ces
nés	ces
rob	ces
vál	ces
sl	ces
prac	slv
sil	ces
táh	ces
tep	ces
vrch	ces
zem	ces
pan	ces
běl	ces
boh	ces
bož	ces
bý	ces
skop	ell
gram	lat,ell
div	ces
dom	ces
hlad	ces
hlás	ces
hlav	ces
hol	ces
hřeb	ces
sol	ces
takt	deu,fra,ell
oper	deu,lat
kost	ces
loup	ces
měř	ces
techn	deu,fra,ell
poj	ces
náš	ces
zř	ces
pí	ces
vés	ces
slav	ces
střed	ces
svít	ces
štíp	ces
taj	ces
tlač	ces
vař	ces
zdrav	ces
rot	ces
cel	ces
styl	lat
čes	ces
kyn	ces
děd	ces
pil	ces
vid	ces
tes	ces
stitu	lat
jí	ces
jm	ces
kaz	ces
klád	ces
kous	ces
kraj	ces
lup	ces
mas	deu,fra,ara,lat,ell
mast	ces
řád	ces
nik	ces
pal	ces
poly	ell
ruš	ces
řed	ces
říd	ces
sáz	ces
slov	ces
škrt	ces
šroub	lat
voj	ces
znam	ces
žal	ces
nom	ell
klam	ces
pak	ces
spir	lat
barv	gmh
boj	ces
čk	ces
teč	ces
t	ces
duk	lat
dřev	ces
eko	ell
plod	ces
has	ces
hn	ces
hrab	ces
kor	ces
vent	lat
kart	ita,lat
vrát	ces
kus	ces
kres	pol,deu
kult	lat
květ	ces
led	ces
léz	ces
mani	deu,lat
měk	ces
vi	ces
nož	ces
pás	ces
plác	ces
spěch	ces
prost	ces
typ	deu,lat,ell
rov	ces
trv	ces
věr	ces
žeh	ces
ur	lat
akt	lat
aut	eng
běž	ces
enk	ces
bi	lat
řeč	ces
h	ces
cen	ces
centr	eng,lat
čas	ces
čern	ces
čist	ces
děj	ces
stol	ces
druž	ces
dram	deu,lat,ell
drob	ces
drž	ces
vok	lat
chyt	ces
jmen	ces
ob	ces
klíč	ces
fes	lat
kur	lat
por	ces
kov	ces
křiv	ces
lin	lat
min	deu,fra,fro
meč	ces
mích	ces
mraz	ces
rok	ces
ší	ces
sp	ces
pár	ces
paž	ces
pěst	ces
písk	ces
skl	ces
zim	ces
pout	ces
srd	ces
stá	ces
stín	ces
tráv	ces
šleh	ces
tlouc	ces
tup	ces
vad	ces
větr	ces
želez	ces
nym	lat,ell
test	lat
auto	lat,ell
bank	ita,deu
bran	ces
cukr	gmh,ita,ara
čel	ces
člen	ces
fekt	lat
kl	ces
nut	ces
strukt	lat
lekt	lat
ud	ces
drát	ces
dus	ces
rup	lat
han	ces
hlas	ces
hlíd	ces
chlad	ces
pres	lat
je	ces
jist	ces
klop	ces
konzerv	lat
ordin	lat
koš	ces
roh	ces
krv	ces
kříž	ces
lák	ces
lí	ces
mez	ces
mín	ces
mít	ces
mlád	ces
moř	ces
muž	ces
tri	ell
oč	ces
var	ces
pln	ces
ráž	ces
sled	ces
sluš	ces
pud	ces
ruk	ces
říz	ces
straš	ces
strč	ces
třep	ces
šoup	ces
švih	ces
trest	ces
trn	ces
véz	ces
vis	ces
vléc	ces
vln	ces
zář	ces
žád	ces
dik	lat
plán	deu,fra,ita,lat
fix	lat
bí	ces
žr	ces
čep	ces
čít	ces
pot	deu,fra,fro,lat
harmon	lat,ell
kut	ces
mn	ces
draž	ces
dup	ces
rud	ces
kluz	ces
sex	eng,lat
hon	ces
host	ces
hrn	ces
hroz	ces
hvězd	ces
chrom	ell
chyb	ces
nac	fra
kamen	ces
klep	ces
kles	ces
klid	ces
knih	ces
penz	lat
kořen	ces
kosm	ell
polit	lat,ell
kroj	ces
krý	ces
lad	ces
lak	deu,ita,ara,pes
léč	ces
lék	ces
líb	ces
mír	ces
mlát	ces
motor	deu,lat
mrk	ces
mr	ces
mý	ces
sup	ces
star	ces
zv	ces
vř	ces
papír	gmh,fro,lat,ell
peč	ces
péc	ces
pěn	ces
pevn	ces
plyn	pol
žár	ces
prch	ces
stran	ces
sah	ces
rub	ces
slad	ces
stih	ces
střík	ces
suš	ces
šed	ces
šlecht	gmh
štv	ces
tav	ces
téc	ces
vlád	ces
vlh	ces
výš	ces
žebr	ces
žh	ces
chron	lat,ell
bab	ces
bíl	ces
byt	ces
blb	ces
ček	ces
bour	ces
br	ces
běr	ces
cest	ces
ciz	ces
cvič	deu
čar	ces
čísl	ces
fin	lat
leg	lat
st	ces
poz	lat
spě	ces
štěp	ces
dým	ces
had	ces
háj	ces
hmat	ces
hodin	ces
hotov	ces
hran	ces
chvál	ces
kas	deu,ita,lat
spekt	lat
racion	lat
jas	ces
jehl	ces
jin	ces
nu	ces
koč	ces
labor	lat
vrat	ces
kuř	ces
krás	ces
krop	ces
lap	ces
lát	ces
slep	ces
lib	ces
liš	ces
liv	ces
loud	ces
lov	ces
mono	lat
muš	deu,fra,ita,lat
roč	ces
noc	ces
or	ces
vah	ces
vět	ces
patr	ces
organ	deu,fra,lat
saz	ces
šat	deu
vád	ces
peř	ces
plen	ces
tok	ces
práš	ces
prásk	ces
prst	ces
ran	ces
trž	ces
růs	ces
sem	ces
skok	ces
slab	ces
slun	ces
speci	deu,fra,lat
su	ces
škod	goh
těl	ces
tyč	ces
uni	deu,fra,lat
veget	eng
ved	ces
věz	ces
zbroj	ces
zd	ces
dvih	ces
znač	ces
dukt	deu,fra,lat
pel	ces
trap	ces
stop	eng
bíd	ces
blud	ces
ovn	ces
mak	ces
ovat	ces
brous	ces
brusl	ces
brzd	ces
ct	ces
čaloun	gmh,fra
čast	ces
čerp	ces
čich	ces
ovsk	ces
ode	ces
hydr	ell
mask	deu,fra
sign	lat
lok	lat
dol	ces
árn	ces
duch	ces
rád	ces
elektr	eng
hal	ukr
hád	ces
hák	gmh
histor	lat,ell
homo	ell
hospod	ces
houp	ces
hrd	ces
hrob	ces
hrub	ces
hřá	ces
hust	ces
chlap	ces
chrán	ces
chut	ces
lustr	lat
plant	fra,lat
kub	lat
scen	lat,ell
sekt	deu,lat
vest	lat
jak	ces
jezd	ces
obe	ces
kadeř	ces
kec	ces
klek	ces
klen	gmh
kler	lat,ell
klub	eng
koj	ces
kombin	lat
kom	lat
post	deu,fra,eng,fro,lat
konč	ces
tuš	ces
korun	lat,ell
kos	ces
krab	ces
krout	ces
krouž	ces
pě	ces
kužel	ces
len	ces
les	ces
lichot	ces
list	ces
sloup	ces
materi	deu,lat
mechan	lat,ell
mlad	ces
mlč	ces
mok	ces
moto	fra
muč	ces
mět	ces
ram	ces
ves	ces
vraž	ces
obil	ces
olej	ces
op	ces
řeš	ces
osm	ces
tvor	ces
vá	ces
per	lat
pích	ces
plak	ces
pliv	ces
plou	ces
tm	ces
třeb	ces
víd	ces
pr	ces
prakt	lat,ell
práv	ces
pros	ces
přím	ces
půjč	ces
rám	gmh
služ	ces
ním	ces
spoř	ces
stan	ces
steh	ces
stráž	ces
strouh	ces
stříd	ces
šach	gmh,dum,fro,pes
šetř	ces
škráb	ces
špič	gmh
šplh	ces
tah	ces
tanč	gmh,fro
tek	ces
tem	ces
tíž	ces
tlak	ces
tn	ces
třás	ces
tříd	ces
tvoř	ces
tvrd	ces
válc	deu
vari	lat
včel	ces
vesl	ces
věř	ces
vláč	ces
zlat	ces
zob	ces
zvon	ces
žvýk	ces
dynam	deu,fra,ell
nul	lat
plik	lat
krat	ell
simil	lat
bus	eng
mobil	fra,lat
bahn	ces
bar	eng,fro
bas	deu,ita,lat
básn	rus
ték	lat,ell
dél	ces
bob	eng
brán	ces
cíl	gmh
civil	deu,fra,lat
cp	ces
cuc	ces
čaj	rus
kněž	ces
červen	ces
dál	ces
grad	lat
děs	ces
šifr	deu,fra,ita
taš	goh
krit	deu,lat,ell
fund	lat
di	lat
krimin	deu,lat
dobr	ces
drážd	ces
drc	ces
drůb	ces
dub	ces
dů	ces
stoj	ces
dv	ces
men	eng
komun	deu,lat
tenz	lat
femin	fra
figur	lat
filtr	deu,lat,deu
fráz	deu,lat,ell
front	deu,fra,ita,lat
fyzi	lat,ell
tesk	pol
hlod	ces
hloub	ces
houb	ces
hud	ces
hrá	ces
tet	ces
cház	ces
chud	ces
chytr	ces
plan	lat
divid	lat
inici	fra,lat
instru	lat
k	ces
átk	ces
kartáč	deu,ita,lat
klín	ces
klouz	ces
klov	ces
klus	ces
kolon	lat
kret	lat
solid	deu,fra,lat
pet	lat
kořist	ces
kouk	deu
koul	gmh
koup	ces
kož	ces
kras	ces
krav	ces
lín	ces
krm	ces
krut	ces
křeh	ces
kvap	ces
kýv	ces
lek	ces
lh	ces
lis	ces
lit	ces
louk	ces
magnet	deu,lat,ell
mám	ces
mar	ces
měšť	ces
mini	ita
míst	ces
miz	ces
ml	ces
modern	lat
muzik	lat,ell
myk	ces
věšt	ces
nerv	lat
not	deu,lat
nud	lat
ocel	ces
puk	ces
ví	ces
památ	ces
park	eng,fra
parti	lat
paš	deu
pátr	ces
patř	ces
peněž	ces
pís	ces
piv	ces
plac	ces
placht	ces
plaš	ces
plát	ces
ply	ces
ruch	ces
sluch	ces
sun	ces
tlach	ces
prš	ces
pruž	ces
sáh	ces
psych	ell
pump	deu,gml,dum
rejd	gmh,fro
soch	ces
rýs	deu
rý	ces
sedm	ces
síd	ces
skříp	ces
slon	ces
slyš	ces
sod	deu,ita,spa,ara
soft	eng
sport	eng,fro,lat
start	eng
stař	ces
stl	ces
strom	ces
sur	ces
svač	ces
sv	ces
škrob	ces
špin	ces
tank	eng
těsn	ces
těš	ces
trat	ces
truhl	gmh
třísk	ces
tvář	ces
rč	ces
uhl	ces
ulič	ces
žit	ces
váh	ces
vesel	ces
vor	ces
vrás	ces
zelen	ces
znám	ces
zrá	ces
zrn	ces
zub	ces
žen	ces
ží	ces
gnost	deu,ell
akc	lat
akro	fra,ell
bel	lat
ment	lat
liter	lat
put	ces
lýz	ell
anim	eng
gon	ell
cip	lat
mon	lat,ell
rest	deu,lat
san	deu,fra,lat
soc	deu,fra,lat
sfér	ell
bad	eng
bav	ces
bedn	deu,lat,ell
beton	fra,fro,lat
biblio	lat,ell
blázn	ces
bled	ces
boč	ces
boř	ces
bul	ces
bouř	ces
brad	ces
brambor	ces
bratr	ces
brn	ces
cap	ces
cell	ita
kros	eng
část	ces
čmár	ces
čtvrt	ces
dar	ces
gener	lat
klas	fra
limit	fra,lat
dem	deu,ell
demo	ell
desát	ces
termin	lat
dět	ces
va	ces
iluz	lat
dikt	deu,lat
díl	ces
diplom	deu,lat,ell
kvali	lat
porc	lat
dív	ces
dluž	ces
dn	ces
druh	ces
dráp	ces
ěn	ces
drog	deu,fra
dř	ces
duc	ces
duh	ces
duš	ces
dvor	ces
dých	ces
migr	lat
energ	ell
lept	ces
pád	ces
uál	lat
hib	lat
exist	lat
expres	fra,lat
fan	deu,lat
fit	eng,fra,lat
flex	lat
fot	eng
geo	ell
glos	lat,ell
gum	lat,ell,egy
uj	ces
hazard	gmh,fro,spa,ara,deu
ház	ces
hléd	ces
hlen	ces
hluch	ces
hněd	ces
hnoj	ces
holub	ces
hous	ces
hrád	ces
hruš	ces
hryz	ces
hřeš	ces
huč	ces
hypn	ell
tax	ell
charakter	deu,lat,ell
chc	pol,chu
chcíp	ces
chor	ces
chran	ces
chřest	ces
chuť	ces
chvát	ces
mit	fra,lat
stant	deu,lat
tox	lat,ell
morf	ell
jím	ces
jitr	ces
juk	ces
kabel	deu,dum,fra
kal	ces
kan	lat
kandid	lat
kapitul	fra,lat
kár	ces
káv	tur,ara
íř	ces
keř	ces
fob	ell
klon	eng,ell
kloub	ces
kolik	ces
komor	lat
mun	lat
rektor	lat
koum	ces
kouř	ces
koz	ces
král	ces
krát	ces
krč	ces
krom	ces
krystal	lat,ell
kry	ces
kryt	lat,ell
křídl	ces
kys	ces
lav	deu,lat
ln	ces
lešt	ces
lex	lat,ell
léh	ces
lich	ces
líp	ces
lít	ces
lod	ces
puch	ces
louč	ces
luč	ces
lušt	rus
lyž	rus
mačk	ces
mách	ces
makro	ell
mandl	deu,gmh,lat,ell
maxim	lat
mdl	ces
měch	ces
směr	ces
mistr	lat
množ	ces
tón	lat,ell
mont	deu,fra,lat
mouč	ces
mrav	ces
mř	ces
mříž	ces
mýt	ces
rat	ces
natur	fra,lat
návštěv	ces
něm	ces
níž	ces
nomin	lat
obět	ces
scén	lat,ell
on	ces
optim	deu,fra,lat
orient	lat
studn	ces
trub	ces
ovoc	ces
paci	deu,fra,lat
ev	ces
pek	ces
pečet	ces
tr	ces
pepř	lat,ell
pér	ces
pěš	ces
pěv	ces
pik	ces
píp	ces
pi	ces
vlas	ces
plech	gmh
ples	ces
plés	ces
pluk	ces
popel	ces
vidl	ces
praš	pol
pras	ces
prask	ces
prd	ces
prezent	lat
program	deu,lat,ell
spěš	ces
řek	ces
prs	ces
přá	ces
puč	deu
půl	ces
pyro	deu,fra,ell
pytl	gmh
radi	lat
rach	lat,ell
ras	deu,fra,ita,lat,ara
real	lat
rez	ces
růž	ces
rol	ces
ros	ces
rošt	gmh
rovn	ces
rychl	ces
rýž	ces
sekund	deu,lat
sn	ces
sí	ces
skal	ces
slíd	ces
slouž	ces
směš	ces
smut	ces
sokol	ces
sr	ces
stabil	deu,lat
stát	lat
stíh	ces
ston	rus
strun	ces
střiž	ces
styd	ces
sukn	ces
sum	lat
symbol	deu,lat,ell
syt	ces
šib	ces
šik	deu
šíl	ces
škub	ces
šněr	deu,gmh
špion	deu,ita,deu
šprým	deu
štět	ces
tábor	ces
tabul	lat
teor	deu,lat,ell
trám	gmh
tren	eng,fra,lat
trén	eng,fra,lat
trop	ces
troub	ces
třes	ces
tuh	ces
ťuk	ces
tur	deu,fra,lat,fro
tvar	ces
uhel	ces
váb	ces
váleč	ces
van	deu,lat
vápen	ces
věk	ces
verš	lat
vš	ces
vé	ces
viol	ita
víř	ces
víj	ces
větř	ces
vlč	ces
vrš	ces
vtip	ces
zed	deu,fra
žab	ces
žel	fra,lat
žluč	ces
norm	lat
hez	lat
opt	lat
ach	ces
klim	deu,lat
bac	ces
kum	lat
bet	lat
alkohol	lat,ara
alter	fra,lat
valent	lat
ovič	ces
štol	lat,ell
tekt	eng,lat
krac	ell
fakt	lat
soci	lat
astr	ell
symetr	lat,ell
atom	lat,ell
gard	fra
bád	pol
báj	ces
band	fra,deu
barok	por
bavln	deu
bič	ces
blah	lat,ell
blan	ces
blesk	ces
týr	ces
bot	fra,lat
brk	ces
broj	ces
brus	ces
bruč	ces
brynd	ces
břich	ces
bubl	ces
buj	ces
buš	ces
bydl	ces
byl	ces
ced	ces
cement	deu,fro,lat
cenz	deu,lat
cibul	gmh,lat
cín	gmh
cít	ces
cuk	deu
ečk	ces
čenich	ces
čest	ces
li	ces
čil	ces
č	ces
čoč	ces
čtver	ces
dár	ces
dáv	ces
eček	ces
dech	ces
kad	ces
dekor	lat
mol	deu,lat
monstr	lat
den	ces
destil	lat
tektor	lat
děv	ces
integr	lat
film	eng
spor	ces
fúz	lat
děr	ces
disk	lat,ell
kant	lat
doj	ces
doktor	lat
dokument	lat
don	lat
nát	lat
dout	ces
drah	ces
drb	ces
drt	ces
dřív	ces
du	lat
dud	ces
dun	deu
duž	ces
dvoř	ces
empir	deu,lat,ell
temp	deu,ita,lat
vert	lat
filo	ell
zof	ell
flák	ces
for	lat
fréz	deu,fra
gal	lat,ell
german	deu
hadr	gmh
haj	lav
hala	deu,gmh
part	deu,gmh
harfen	ces
heb	ces
her	lat
hierarch	lat,ell
hlin	ces
hloup	ces
hlt	ces
hán	ces
hní	ces
hnízd	ces
hobl	deu
hoj	ces
hokej	eng
hospit	eng,lat
houk	ces
housl	ces
hov	ces
hovor	ces
hrb	ces
hříb	ces
humor	lat
hvízd	ces
hygien	deu,fra,ell
hyn	ces
mangan	deu,ita
hyster	lat,ell
chat	ces
chem	deu,lat,ell
chleb	ces
chlíp	ces
chlór	ell
chmel	ces
chochol	ces
chop	ces
choul	ces
chrup	ces
cht	ces
ide	lat,ell
orn	ces
pul	deu,lat
semin	deu,lat
stal	fra
mentál	lat
intelekt	lat
intelig	lat
venc	lat
venč	lat
iron	lat,ell
izol	fra,ita,lat
jacht	eng,nld
jed	ces
jelen	ces
jikr	ces
jíl	ces
jitř	ces
jív	ces
ně	ces
kabát	ces
del	ces
kachl	deu,lat,ell
kaka	spa
kališ	gmh,lat
kamarád	lat
kanál	lat,ell
kano	eng,spa
kast	deu,fra,por,lat
kaš	ces
kašl	ces
klap	ces
klešt	ces
klik	ces
kmotr	ces
kníž	ces
knír	ces
kňour	lit,deu
kobyl	ces
koc	ces
ovin	ces
ko	lat
kokt	ces
koleg	lat
komedi	lat,ell
míh	ces
mis	lat
pozit	deu,lat
gres	lat
stel	ces
text	lat
punkt	lat
kontrol	deu,fra,frm,lat
zerv	deu,fra,lat
konzum	lat
kopul	lat
kopyt	ces
spond	lat
korz	ita,lat
kostým	deu,fra,ita,lat
košil	ces
kot	ces
kul	ces
kouzel	ces
kouzl	ces
kraul	eng
kresl	pol,deu
kriminal	deu,lat
krot	ces
křeč	ces
křiž	ces
kuch	lat
kůr	lat,ell
kurát	lat
kuš	deu,fra
kvant	lat
kvart	lat
kvas	ces
kvés	ces
kyd	ces
kých	ces
kýl	deu
kyp	ces
kyt	deu
lajn	eng,lat
lamin	lat
lamp	gmh,fro,lat
motiv	deu,lat
lst	ces
líc	ces
líč	ces
lud	ces
lichv	ces
lišt	gmh,deu
př	ces
líz	ces
lk	ces
loď	ces
los	deu
luk	ces
loutk	ces
lyr	lat,ell
magistr	lat
maj	ces
malin	ces
mam	ces
manžel	goh
map	deu,lat
pán	deu,ita
mark	deu
marod	deu,fra
mař	ces
mát	ces
matem	lat,ell
matur	deu,lat
melod	lat,ell
pauz	deu
měsíč	ces
mešk	ces
míč	ces
minc	deu,lat
míř	ces
mlask	ces
mlék	ces
model	deu,fra,ita,lat
gam	lat
most	ces
mraven	ces
mrsk	ces
mršt	ces
mst	ces
muchl	ces
my	ces
mýšl	ces
myst	lat,ell
mžik	ces
naft	deu,lat,ell,pes
palm	eng
neb	ces
nech	ces
vist	ces
nič	ces
lič	ces
ráz	ces
vet	deu
ochot	ces
fren	ell
opět	ces
pět	ces
orto	ell,lat
sád	ces
oscil	lat
osob	ces
ostruž	ces
ostř	ces
otrok	ces
tyl	ces
pac	deu,fra
pachol	ces
pacht	deu,lat
páj	rus
palub	rus
panel	deu,gml,fro,lat
patriot	deu,fra,lat,ell
paz	ces
perl	lat
person	lat
pian	deu,fra,ita,lat
pitom	ces
plag	deu,fra,lat
plach	mkd
planet	lat,ell
plesk	ces
pleš	ces
plov	ces
polem	deu,fra,ell
polic	lat,ell
polštář	gmh
lyk	ces
popul	lat
portrét	deu,fra,fro,lat
ten	ces
těr	ces
pozd	ces
vat	deu
žír	ces
pragm	lat,ell
praž	ces
prolet	lat
propag	deu,fra,lat
prsk	ces
prv	ces
přáh	ces
před	ces
přísn	ces
zrak	ces
punt	gmh,lat
pup	ces
purit	eng
rab	ces
radik	deu,fra,lat
rafin	fra,fro
rákos	ces
regul	lat
reklam	deu,fra,lat
republik	fra,lat
restaur	deu,fra
revm	deu,lat,ell
romant	fra
rošť	ces
růst	ces
rým	gmh,fro,sga,ell
rýp	ces
řehol	lat
řeht	ces
řemesl	ces
řv	ces
sabot	fra
sádr	ces
sál	deu,deu
sáň	ces
sav	ces
sá	ces
seč	ces
sekret	lat
semi	lat
senz	lat
sever	ces
simul	lat
situ	deu,fra,lat
slabik	lat,ell
slád	ces
slin	ces
slint	ces
sliz	ces
sluh	ces
smeč	eng
smrad	ces
sněž	ces
sof	eng
sól	ita,lat
spirit	lat,ell
spod	ces
stár	ces
statist	deu,lat
steril	deu,fra,lat
strast	ces
stříl	ces
super	eng
svat	ces
svěc	ces
svin	ces
vrab	ces
syno	lat,ell
syr	ces
system	deu,lat,ell
šavl	ces
šéf	deu,fra,fro,lat
šejd	ces
šept	ces
šir	ces
škvař	ces
šláp	ces
šovin	fra
špek	deu
štěk	ces
šťouch	deu
ťap	ces
těk	ces
těst	ces
textil	deu,lat
tich	ces
tiš	ces
tip	eng
tisíc	ces
titul	lat
tkan	ces
tlesk	eng
tlum	pol
tlumoč	ces
traktor	deu,eng,fra
tramvaj	eng
tranz	deu,eng
tráp	ces
atlon	ell
trous	ces
trs	ces
trud	ces
trysk	ces
třešt	ces
tuč	ces
tuch	ces
tunel	deu,eng,fro
tyran	lat,ell
der	ces
uzl	ces
úz	ces
vandal	deu
vdov	ces
věc	ces
veterin	deu,fra,lat
veteš	ces
věž	ces
vibr	lat
vil	deu,lat
violon	ita
vít	ces
vítěz	ces
vlek	ces
volej	eng
vosk	ces
vous	ces
vrávor	ces
vrz	ces
vřísk	ces
vzor	pol
zoo	ell
zrc	ces
zvíř	ces
žebř	ces
žehn	gmh,lat
želv	ces
živ	ces
žlout	ces
žurnal	fra,lat
žvan	ces
solv	lat
tin	ces
trak	deu,lat
trah	lat
trakt	deu,lat
dres	fra,lat
agent	deu,lat
ag	deu,fra,lat
akadem	lat,ell
bat	fra,ell
tom	lat,ell
anděl	ces
dat	lat
parát	lat
strof	lat,ell
archeo	deu,ell
aristo	ell
arom	lat,ell
te	ell
audit	eng,lat
aul	ell
autor	lat
strád	ces
avi	fra,lat
víz	deu,lat
buk	ces
balon	deu,fra,ita,deu
banán	deu,spa,por
barbar	lat,ell
barik	deu,fra,fro
baryton	ita,ell
base	eng,fra
ball	eng,fra
basket	eng
žin	ces
bazén	fra,lat
bažant	gmh,lat,ell
beč	ces
be	deu,fra
letr	deu,fra
berl	lat
besed	ces
biatlon	lat,ell
bibl	lat,ell
board	eng
biřm	gmh,lat
bíj	ces
vak	deu,fra,deu,nld
blaf	eng
blaž	lat,ell
blát	ces
blat	ces
se	ces
blik	gmh
bloud	ces
blouzn	ces
blůz	deu,fra
bolšev	ces
bomb	deu,fra,ita,lat,ell
bon	deu,fra,lat
bonbon	deu,fra
bordel	deu,fro,lat,deu
boul	ces
pode	ces
brázd	ces
breč	ces
brejl	deu,gmh
brok	deu
brouk	ces
brož	fra
břez	ces
bubn	ces
budd	ind
bufet	fra
bund	hun
burz	lat,ell
býl	ces
byro	fra
bzuč	ces
cák	ces
cedul	lat
cejch	gmh
celt	deu
fug	fra,lat
certi	lat
cév	ces
ich	ces
cink	ces
cirkul	lat
cirkus	deu,lat,ell
nád	deu,ita,lat
cl	gmh,lat,ell
clon	ces
cour	ces
couv	deu,gmh
ve	ces
ctn	ces
cvak	ces
čár	ces
čechr	ces
čerstv	ces
čert	ces
číh	ces
čir	ces
čís	ces
čt	ces
číš	ces
čá	ces
člověč	ces
člun	ces
čn	ces
čokolád	ita,spa
čp	ces
črt	ces
čub	gmh
čum	ces
čundr	deu
čur	ces
čut	eng
dada	fra
dal	ces
dareb	ces
daj	ces
db	ces
debat	deu,fra
debl	eng,fra,lat
fraud	lat
gust	ita,lat
dek	gmh
děk	ces
agog	deu,ell
démon	lat,ell
dent	lat
priv	deu,lat
deriv	lat
derm	ell
deset	ces
design	eng,fra,lat
desk	ces
strukc	lat
dešt	ces
detail	fra,lat
vast	lat
dezert	fra,lat
fekč	fra
fekc	fra
didakt	deu,ell
dilet	deu,ita,lat
dír	ces
direkt	fra,lat
rig	deu,lat
krét	fra,lat
pozic	lat
tribu	lat
dlážd	ces
dlažd	ces
dloub	ces
dlouh	ces
dlouž	ces
adl	ces
din	ces
dogm	lat,ell
aturg	lat,ell
drav	ces
dribl	eng
drk	ces
drnč	ces
drnk	ces
drožk	rus
dryáč	lat,ell
drz	ces
dřep	ces
dum	pol,rus
duř	rus
stojn	ces
dut	ces
dveř	ces
džbán	ces
eklekt	deu,ell
ekvilibr	fra,lat
ekvi	lat
emis	lat
entuz	deu,ell
p	lat
ryt	ces
estet	ell
vaku	lat
evangel	lat,ell
iál	lat
kav	lat
exot	deu,lat,ell
experi	lat
teriér	eng
extra	fra,lat
fabrik	deu,lat
faktur	deu,lat
faleš	gmh,fro,lat
falzi	lat
fant	deu,lat
fantaz	fra,ell
far	gmh,lat,ell
farm	eng,fro,lat
faš	ita,lat
fáz	deu,ell
fazol	deu,lat,ell
feder	lat
fest	deu,lat
fetiš	fra,por,lat
atel	fra,ell
final	lat
finanč	deu,fra,fro,lat
fint	ces
fisk	lat
flám	deu
flekt	deu,lat
fluktu	lat
flus	deu
folklor	eng
fouk	ces
frank	ita,deu
frant	ita
fun	lat
futr	deu
gastr	fra,ell
generál	lat
gest	lat
gól	eng
gran	lat
gril	eng,fra,lat
gro	ita,lat
guvern	fra,lat
gymnast	ell
gyn	ell
hab	lat
hamiž	gmh
handl	deu
harpun	deu,dum,frm
hédon	ell
hejk	ces
hek	ces
heli	lat,ell
hemat	ell
herald	lat
hesl	ces
hetero	eng,lat
histo	ell
mor	ces
hlahol	ces
hlíz	ces
hlup	ces
hlub	ces
hluč	ces
hmát	ces
hmit	ces
hmot	ces
hmyz	ces
háň	ces
hnis	ces
hnus	ces
hokyn	gmh
homol	ces
honor	lat
hop	ces
hůř	ces
pahor	pol
houf	gmh
hrach	ces
hromad	ces
hrot	ces
hrud	ces
hřad	ces
hul	ces
humus	lat
hus	ces
hut	gmh
hybrid	lat
hymn	lat,ell
téz	ell
hýř	ces
hyzd	ces
chalup	ces
chirurg	lat,ell
chlast	ces
chlup	ces
chmur	ces
chobot	srp,hrv
choreo	ell
chrast	ces
chrono	ell
chur	ces
chval	ces
ideal	lat
identi	lat
idiot	lat,ell
imagin	lat
manent	deu,fra,lat
imit	lat
imper	lat
imperi	lat
gn	lat
imun	lat
jekc	lat
spek	lat
valid	fra,lat
vekt	lat
zult	lat
inženýr	fra,fro,lat
relev	lat
jabl	ces
jáhen	lat,ell
jahod	ces
jal	ces
jan	ell
jar	ces
jás	ces
játr	ces
jazyk	ces
jazz	eng
jek	ces
jedl	ces
jeřáb	ces
jezer	ces
jež	ces
jizb	ces
jizv	ces
ouc	ces
jud	eng,jpn
kabaret	fra
kác	ces
kacíř	gmh
kadet	fra,lat
kádr	deu,fra,ita,lat
kafr	gmh,lat,ara
kajut	deu,dum
kalend	lat
kalhot	ces
kalk	lat
kalkul	lat
kamer	lat
kamn	ces
můr	jpn
káp	ces
kapital	deu,ita,lat
kapust	gmh,lat
karabin	fra
karamel	fra,spa
karik	ita,lat
kaskád	fra,ita,lat
kat	ces
pult	deu,lat
katedr	lat,ell
kategor	lat,ell
katol	lat,ell
kaučuk	fra,spa
íček	lat
kd	ces
kemp	eng,lat
křov	ces
klarin	ita,lat
klasic	deu,fra,lat
klát	ces
klaun	eng,isl,swe,dan,lat
klavír	deu,fra,lat
klec	ces
klest	ces
klet	ces
klobouč	ces
klopýt	ces
kmit	ces
kned	gmh
kód	eng,fra,lat
kod	lat
kohout	ces
koket	fra
kolís	ces
koment	lat
ial	fra,lat
komín	ces
komis	lat
é	ces
komol	ces
parat	lat
kompet	lat
kompil	lat
koneč	ces
fuz	lat
greg	lat
son	lat
templ	lat
kopr	ces
kopřiv	ces
koř	ces
naut	ell
kostel	slk,pol
košt	deu
kót	fra,lat
kotv	ces
kouč	eng
koudel	ces
kovboj	eng
kr	ces
kráš	ces
krejč	ces
krém	fra,fro,lat,ell
írn	ces
krev	ces
krk	ces
kronik	lat,ell
krup	ces
kruh	ces
kruž	ces
krychl	ces
krys	rus
křesť	ces
křik	ces
křič	ces
kříd	gmh,lat
křís	pol
křt	ces
křup	ces
kudr	ces
kuchyň	lat
kuk	ces
kůl	ces
kulh	ces
kumul	lat
kúr	lat
kvádr	deu,lat
kval	lat
kvik	ces
kvíl	ces
kvit	deu,fra,lat
kviz	lat
kyber	eng
net	eng
kyj	ces
kyno	ell
kysel	ces
kysl	lat,ell
kytar	ell
kyv	ces
labuž	ces
lahv	goh
lahod	ces
larv	lat
lasc	lat
lať	gmh
laureát	lat
lax	deu,lat
leb	ces
legend	lat
lekc	lat
lem	ces
lešen	ces
lét	ces
lexik	lat,ell
liber	lat
libr	lat
licit	lat
lih	deu
likvid	ita,lat
lím	ces
lingv	lat
líst	ces
lé	ces
aritm	ell
lopat	ces
losos	ces
lotr	lat
louh	gmh
lousk	ces
lusk	ces
luterán	deu
lux	lat
lýk	ces
lynč	eng
lžíc	ces
major	deu,spa,lat
mamon	lat,ell,arc
skript	lat
mariáš	fra
marin	fra
market	eng,lat
másl	ces
masoch	deu
mašl	deu
matr	deu,gmh,ita
máv	ces
medit	lat
medvěd	ces
melior	lat
melouch	deu
menstru	lat
menš	ces
mentor	ell
més	ces
fyz	lat,ell
tez	deu,lat,ell
meteor	deu,lat,ell
metod	deu,lat,ell
metro	deu,lat,ell
míj	ces
míl	gmh,lat
mili	ita,lat
milic	deu,lat
militar	deu,fra,lat
mim	lat,ell
minerál	deu,lat
minut	deu,lat
mís	ces
mision	lat
mix	eng,lat
mlž	ces
mlh	ces
mlouv	ces
modi	lat
modr	ces
modř	ces
moh	ces
molekul	fra,lat
moment	deu,lat
mour	ces
movit	ces
mrak	ces
mruč	ces
mut	lat
narko	ell
něž	rus
teř	ces
utral	lat
nevěst	ces
nihil	lat
nit	ces
nít	ces
nitr	ces
niv	ces
nivel	deu,fra,frm,fro,lat
noh	ces
rož	ces
notor	deu,lat
nudl	deu
num	deu,lat,ell
nyn	ces
nýt	deu
o	ces
obec	ces
oběd	ces
obuv	ces
vyk	ces
oct	ces
od	ell
mk	ces
dí	ces
pušt	ces
růd	ces
set	eng
ohn	ces
olymp	ell
onko	ell
páč	ces
oportun	fra,lat
prud	ces
dox	lat,ell
smah	ces
ostr	ces
střic	rus,nld,lat,ell
otav	ces
vír	ces
oxid	deu,fra,ell
pacient	lat
pák	ces
pamět	ces
pant	deu,lat,ell
pante	ell
pap	ces
papež	ces
papouš	deu,slk,rus
pař	ces
parád	deu,fra,spa,lat
parket	fra
parod	deu,fra,lat,ell
pasiv	deu,fra,lat
pastel	deu,fra,ita
pát	ces
patent	deu,fra,lat
patri	lat
páž	fra
peck	ukr
period	ell
petr	ces
petrolej	deu,ell,lat
petržel	gmh,lat,ell
pij	ces
pirát	deu,ita,fro,lat,ell
písm	ces
pistol	deu,fra
plachet	ces
pla	ces
plast	deu,fra,lat,ell
pleb	deu,lat
plemen	ces
plesn	ces
ploš	deu
plotn	deu
pohár	slk,lat,ell
sémi	ell
ponděl	ces
pouz	ces
pruh	ces
popular	lat
porcelán	deu,ita
porn	fra,ell
sel	ces
suv	ces
svíc	ces
pošť	deu,ita,lat
poust	ces
poušt	ces
věst	rus
vlak	ces
póz	deu,fra,lat
prach	ces
pramen	ces
prašt	ces
prázdn	ces
premi	lat
prezid	lat
seb	ces
stěr	ces
proud	ces
prub	deu,lat
pych	ces
přesn	ces
příbuzen	ces
přád	ces
příšer	ces
štip	ces
tak	ces
ptáč	ces
puc	deu
půd	ces
pudr	deu,fra,fro,lat
punc	deu,ita,lat
punčoch	deu
pur	fra,lat
purpur	deu,lat
pus	deu
puš	gmh,lat,ell
pysk	ces
ráč	ces
rádi	deu,eng,lat
rajc	deu,eng
raket	deu,ita
rakovin	ell
rašelin	ces
region	deu,lat
rekord	eng,fro,lat
kre	lat
remíz	fra,lat
rent	deu,fra,lat
rentgen	deu
ret	ces
retro	fra,lat
rév	gmh
revanš	deu,fra,fro,lat
revol	deu,lat
rezid	lat
zign	lat
rež	fra,lat
risk	deu,fra
robot	ces
rock	eng
román	deu,fra,fro
ron	ces
rosol	rus,srp
rovin	ces
teln	ces
rtuť	ces
rus	ces
vlás	ces
rutin	fra,lat
různ	ces
rýh	gmh
rycht	gmh
rytíř	gmh
řas	ces
řep	ces
řetěz	ces
řík	ces
řk	ces
řid	ces
říj	ces
salon	fra,ita,deu
sám	deu
satan	lat,ell,heb
sec	lat
seiz	ell
senior	lat
senti	eng
schem	deu,lat,ell
scholast	lat,ell
síl	ces
silon	ces
sinus	lat
sir	ces
sirk	ces
síť	ces
sít	ces
skic	deu,ita
sklep	ces
skřiv	ces
slám	ces
slatin	ces
slíb	ces
slz	ces
smalt	ita,deu
sm	ces
smol	ces
smrd	ces
snaž	ces
níd	ces
socio	deu,fra,eng
sond	deu,fra
struh	ces
spas	ces
speleo	lat,ell
spirál	lat,ell
sponzor	eng,lat
sprej	eng
spurt	eng
stač	ces
stěn	ces
step	rus,ukr
stereo	deu,fra,ell
stimul	lat
stomat	ell
strup	ces
střap	ces
střeš	ces
střev	ces
střik	ces
stříz	ces
stupid	lat
suk	ces
vár	ces
svát	ces
svěž	ces
svit	ces
svobod	ces
syk	ces
syn	ces
systém	deu,lat,ell
šablon	deu,dum,fro,lat
šál	deu,fra,eng,pes
šamot	deu
šer	ces
šilh	gmh
šíř	ces
šiš	ces
škatul	slv,lat
škrab	ces
škvár	ces
škyt	ces
šmik	ces
šňup	deu,deu
šofér	deu,fra
šok	eng,fra
šperk	ces
špon	deu
šťast	ces
štěbet	ces
štk	ces
šup	ces
šupin	deu
šust	ces
švindl	deu
taž	ces
talent	deu,lat,ell
talíř	deu,lat,gmh
tam	ces
taneč	gmh,fro
táp	ces
tat	ces
ejš	ces
tenor	deu,ita,lat
teo	lat,ell
teras	deu,fra,lat
term	deu,lat,ell
termín	lat
teror	lat
tik	ces
tísn	ces
tlap	ces
topor	ces
touž	ces
továr	ces
trad	deu,lat
trag	lat,ell
tramp	eng
traum	deu,ell
trém	ces
trik	eng,fra,fro,lat
triumf	lat,ell
trolej	eng
troseč	ces
trosk	ces
truc	gmh
trumf	deu
trumpet	deu,fra,fro,frk
trůn	gmh,fro,lat,ell
trýzn	ces
třesk	ces
tříb	ces
tuk	ces
tvár	ces
týden	ces
tyf	lat,ell
týl	ces
úhel	ces
úst	ces
úter	ces
trakv	lat
uzurp	lat
vandr	deu
vápn	ces
varhan	lat,ell
vář	ces
vášn	ces
včer	ces
večer	ces
vějíř	rus,deu
věč	ces
veksl	deu
veleb	ces
věn	ces
ventil	deu,lat
verb	lat
veřej	ces
vůd	ces
veš	ces
visk	lat
vlaž	ces
vlašt	ces
vran	ces
vrb	ces
vrstv	ces
vřes	ces
výsk	ces
vzduch	rus
work	eng
ohol	eng
xeno	ell
hál	ces
zelin	ces
zív	ces
znak	ces
zouf	ces
zír	ces
zuř	ces
zvlášt	ces
zvuk	ces
žad	ces
žalm	lat,ell
žárl	deu,fra,ita,lat,ell
žas	ces
žeml	gmh,lat
žert	gmh
žid	ces
žil	ces
žín	ces
žlut	ces
žul	gmh,lat
žup	ces
abeced	lat
abit	deu,lat
urient	deu,lat
ablat	lat
absolut	lat
absurd	lat
ekvát	lat
adolescent	lat
adres	fra,lat
advent	lat
advok	lat
aero	ell
aerosol	eng
agit	lat
gnos	ell
agon	lat,ell
agres	lat
bag	eng
akč	lat
cent	lat
akci	deu,nld,lat
kred	fra,lat
aktu	lat
akust	ell
alerg	ell
alf	ell,heb
alchym	spa,ara,ell
ali	lat
alt	ita,lat
altán	deu,ita,lat
alumini	eng,lat
amalgám	deu,lat
am	fra,lat
atér	fra,lat
ambic	lat
ambi	lat
amnest	lat,ell
mort	deu,fra,lat
báz	ell
lyz	ell
lyt	ell
angín	lat
ano	lat,ell
anta	ell
bio	ell
koncepč	lat
antuk	fra
apat	lat,ell
aplik	lat
apologet	lat,ell
apríl	lat
arašíd	fra,lat,ell
archi	lat,ell
tekton	lat,ell
archiv	lat,ell
ári	ita
arit	lat,ell
armád	spa,lat
arti	lat
artist	fra,lat
rytmic	lat,ell
asfalt	lat,ell
asist	deu,lat
asket	deu,ell
atav	fra,lat
atlet	lat,ell
aug	lat
kar	eng
aviat	fra
azbest	ell
azur	fra,lat,ara
azyl	deu,lat,ell
ba	ces
báb	ces
babr	ces
bacil	lat
bačkor	hun
baf	deu,dan
bagr	nld
bajk	ces
bakalář	lat
bál	deu,fra,fro,lat
balet	deu,ita,lat
balkon	deu,fra,ita,deu
balvan	lat
bambul	hun
bambus	deu,nld,zlm
bandit	ces
bapt	lat,ell
barák	deu,fra,spa
baráž	fra
barbor	ell
baron	deu,fra,fro,lat,deu
barev	gmh
bašt	ces
bateri	fra,fro,lat
batik	nld,zlm
batist	fra
bazilik	lat,ell
bažin	ces
bděl	ces
beati	lat
bedl	pol
bedr	ces
beduín	fra,ara
bekhend	eng
belh	ces
benzin	spa,ara
beran	ces
bér	rus
běs	ces
best	lat
bešamel	fra
ick	lat,ell
bifl	deu
fok	lat
big	eng
bít	eng
laterál	lat
bilet	fra,fro
biliár	fra,lat
bili	fra
ouš	ces
bij	ces
bizar	fra,ita
bizon	eng,lat,ell,deu,prg
blábol	ces
bláh	ces
blán	ces
blasfem	lat,ell
bleš	ces
blek	ces
blíz	ces
blíž	ces
blok	deu
blondýn	fra,lat,deu
blues	eng
bluf	eng
blýsk	ces
bobul	slk
bodr	deu
body	eng
boch	gmh,lat
bój	deu,dum,fro
bojkot	eng
botan	deu,lat,ell
boud	ces
ňák	ces
box	eng
brašn	ces
brav	ces
si	ces
brept	ces
brigád	deu,fra,ita
brnk	ces
brod	ces
brokát	deu,ita
brom	deu,fra,ell
bronz	deu,ita
broskv	lat
brouč	ces
brouzd	ces
brunát	gmh
brunet	fra,deu
brz	ces
břečť	ces
břež	ces
břidl	ces
břím	ces
břink	ces
bříz	ces
bub	ces
buben	ces
bublin	ces
bubř	ces
buč	ces
bucht	ces
bulvár	fra,dum
ang	eng
buran	gmh,rus
burc	ces
burlesk	deu,ita,lat
buržoaz	fra,deu
butan	lat,ell
buvol	lat,ell
býč	ces
bystř	ces
bzik	ces
cajk	deu
car	rus,orv
cech	gmh
celer	deu,ita,lat,ell
fán	fra,ell
celul	eng
celulóz	deu,fra,lat
celk	ces
cenzur	lat
ceremon	fra,lat
cív	ces
cigaret	deu,fra,spa
cihl	gmh,lat
cimbál	lat,ell
cíp	gmh
církev	ces
cirkumflex	lat
císař	ces
cís	ces
citron	deu,ita,lat
citr	deu,ita,lat
inec	ces
cizrn	deu,gmh,lat
clearing	eng,fro,lat
com	eng,fra,lat
puter	eng,fra,lat
cop	deu
coul	deu
cud	ces
cuker	gmh,ita,ara
cup	ces
cvik	deu
cvrnk	ces
cyn	lat,ell
cypřiš	lat,ell
čad	ces
čah	ces
čáp	ces
čap	ces
čárk	ces
čardáš	hun
čed	ces
češ	ces
čekan	lat
čelist	ces
čeln	ces
čepýř	ces
červ	ces
čeř	lav
česnek	ces
čí	ces
čiž	ces
čuch	ces
činž	gmh,lat
čiš	ces
čmoud	ces
čmuch	ces
čtyř	ces
čun	ces
čuň	ces
ďábel	lat,ell
daktyl	lat,ell
daktylo	ell
lám	mon
po	ces
daň	ces
dan	ces
dárc	ces
darm	ces
zdatn	ces
datl	gmh,lat,ell
dav	ces
dcer	ces
debil	lat
debut	fra
decent	deu,fra,lat
fenz	deu,lat
fét	fra,lat
deficit	lat
flor	lat
dch	ces
děkan	lat
klar	lat
klin	lat
ítk	ces
dě	ces
demark	fra,spa,deu
depres	lat
depriv	lat
des	ell
destinac	lat
dešť	ces
tekc	eng,lat
tekč	eng,lat
det	fra,lat
valv	eng,fra,lat
devít	ces
deviz	deu,fra
devót	deu,lat
ori	fra
diabol	ita
gnóz	ell
lyzač	ell
mant	deu,fro,lat,ell
diesel	deu
diet	deu,lat,ell
dikc	lat
menz	lat
direktor	deu,lat
junkc	lat
diskus	lat
porč	lat
dist	fra,lat
diviz	fra,lat
dlab	ces
dlaň	ces
dlát	ces
í	ces
dluh	ces
dm	ces
dmých	ces
dneš	ces
docent	lat
doktr	deu,lat
dolar	eng,deu
est	eng,lat
domin	lat
kichot	lat
pink	eng
ping	eng
dort	ces
savad	ces
doš	gmh
dou	ces
draft	eng
drag	fra,lat
oun	fra,lat
dráh	ces
drak	lat,ell
dranc	ces
drap	ces
drás	ces
dr	ces
drh	ces
drmol	ces
drn	ces
drnc	ces
drol	ces
drs	ces
dřím	ces
ěj	ces
duál	lat
ďub	ces
dumping	eng
dur	lat
dural	lat
důtk	ces
dýh	ces
dych	ces
dycht	ces
dynast	deu,ell
dyslekt	ell
peps	ell
džentl	eng
džus	eng,fra,lat
eben	lat,ell
ech	ces
kraz	fra,enm
ekumen	lat,ell
element	lat
emigrant	deu,lat
iast	deu,ell
numer	lat
fýz	ell
sko	lat
epik	ell
erár	deu,lat
esej	eng,fro,lat
ese	deu
eskam	fra,lat
estrád	fra,spa,lat
etap	deu,fra,dum
etáž	fra
eufem	ell
eufon	lat,ell
event	fra,lat
evid	lat
exe	lat,ell
hum	lat
exil	lat
kurz	lat
expanz	lat
pand	lat
plicit	lat
plo	fra,lat
ploz	lat
tern	lat
ter	lat
extremist	deu,fra,lat
fabul	lat
fád	fra,lat
cyt	ell
fach	deu
fajn	deu,fro,lat
falz	ita,lat
fár	deu
farizej	lat,ell,arc
farmaceut	lat,ell
fascin	lat
fas	deu
faul	eng
faun	lat
fejeton	fra,lat
fér	eng
fermež	gmh,fra
festival	eng,fro,lat
feudál	deu,lat,deu
fial	gmh,lat
fič	ces
fík	lat
fik	ces
filc	deu
fili	deu,lat
filip	ces
filumen	lat
finál	deu,ita,lat
fing	deu,lat
finiš	eng,fro,lat
flamb	fra,fro,lat
flanel	deu,eng
flašinet	ces
flauš	deu,gml
flegm	lat,ell
flek	deu
flét	deu,fro
flirt	eng
fofr	deu,lat
folk	eng
fond	deu,fra,lat
fondán	fra,lat
fonet	ell
fór	deu
forhend	eng
fosfor	deu,ell
fuk	ces
fragment	lat
frajeř	deu
frašk	ita
frekvent	lat
frigid	lat
frit	fra,lat
fuč	deu
fuj	ces
fundamental	lat
fuš	deu
futur	lat,ell
gábl	deu
galán	deu,spa,fro
gar	deu,fra,fro,deu
garde	deu
gauč	eng,fra,lat
geril	spa,deu
olog	ell
glad	lat
glob	fra
glori	lat
gnóm	lat
gnoze	ell
golf	eng
gondol	ita
grád	deu,lat
granát	gmh,lat
grant	eng,fro,lat
grat	lat
gravid	lat
grav	fra,eng,lat
griliáš	fra
grobi	deu,lat
gubern	lat
guláš	deu
habr	ces
halas	ces
halek	ces
haléř	gmh,deu
halu	lat,ell
in	lat,ell
ham	eng
handi	eng
harc	hun
ware	eng
harmonik	eng,lat
haš	fra,deu
havíř	deu
havran	ces
házen	ces
hbit	ces
hebk	ces
hec	deu
hedváb	goh
hegemon	ell
helikon	ell
helm	gmh
herb	lat
hermen	ell
hero	lat,ell
heřmán	lat,ell
heur	ell
hiát	lat
drom	ell
hláš	ces
hláv	ces
hle	ces
hloh	ces
hluk	ces
hned	ces
hněv	ces
hnid	ces
hni	ces
hoboj	deu,fra,lat
hold	gmh
holo	ell
hůr	pol
horizont	deu,lat,ell
hormon	eng,ell
horor	eng,lat
hot	deu,fra
hotel	deu,fra,fro,lat
hup	ces
housen	ces
houšt	ces
houžev	ces
hra	ces
hr	ces
hráb	ces
hrazd	ces
hrdl	ces
hrk	ces
hrnč	ces
hrozn	ces
hrtan	ces
hrož	ces
hřbet	ces
hřbitov	goh
íčk	ces
hřib	ces
hřídel	ces
hříš	ces
hudl	deu
hugenot	deu
hůlk	ces
humr	deu,isl
husar	hun
houst	ces
hutn	ces
hvozd	pol
hýb	ces
hyen	lat,ell
hýk	ces
chondr	ell
chab	ces
chameleon	lat,ell
chamt	ces
cháp	ces
charit	lat
chas	ces
chatař	ces
chátr	ces
chimér	deu,lat,ell
chláchol	ces
peň	ces
chmat	ces
chňap	deu
choz	ces
choler	deu,lat,ell
chom	ces
chór	lat,ell
chout	ces
chrabr	rus
chrám	ces
chrč	ces
chrchl	ces
chrl	ces
chrn	ces
chromozom	ell
chroup	ces
chrp	ces
chrst	ces
chrt	ces
chřipk	ces
chuligán	rus,eng,gle
chumel	ces
chva	ces
chvat	ces
chvil	ces
chýl	ces
chyst	ces
ideál	lat
idio	ell
idyl	deu,fra,lat,ell
igelit	deu
ignorant	lat
ikon	rus,chu,ell
iko	ell
lumin	lat
ilustr	lat
matrikul	lat
matrik	lat
augur	lat
indig	ces
industri	fra,lat
infarkt	deu,lat
inher	deu,lat
jekč	lat
karn	lat
inkoust	lat,ell
inkviz	lat
tor	lat
spekc	lat
stanc	lat
instinkt	lat
instruktor	rus
integrál	lat
interes	fra,lat
mezz	ita,lat
intern	lat
pret	lat
punkc	lat
intim	lat
intrik	fra,ita,lat
intrikán	fra,ita,lat
inzer	deu
inzul	fra,lat
iont	eng,ell
rac	lat
irit	lat
ischem	lat,ell
jablk	ces
jádr	ces
jáhl	ces
jako	ces
jalovc	ces
jám	ces
jam	ces
jařm	ces
jasan	ces
jater	ces
jaternic	ces
javor	ces
jazýč	ces
ječ	ces
jedin	ces
jelit	ces
jen	ces
jep	ces
jeskyn	ces
jesl	ces
jestřáb	ces
ješit	ces
ještěr	ces
jetel	ces
jev	ces
jez	ces
jízd	ces
jížd	ces
jezev	ces
již	ces
jih	ces
jík	ces
jilm	pol,chu
š	ces
jirch	gmh,lat
jiskr	ces
jiskř	ces
jís	ces
jíd	ces
jíšk	ces
jód	fra,ell
jóg	ces
jogurt	tur
som	ces
judik	lat
jut	eng
kabin	deu,fra,eng,frm,lat
kabinet	fra
kabon	ces
kachn	ces
kajíc	ces
kak	ces
kako	ell
kaktus	lat,ell
kál	ces
ka	ces
kaleido	ell
kali	ell
kalich	gmh,lat
kalik	fra,eng
kalor	fra,lat
kam	ces
kamín	ces
kamion	fra
kamizol	fra,lat
kamz	deu,lat
kanár	spa
kancelář	lat
kani	spa
kanibal	spa
kanon	deu,fra,ita,lat
kantýn	deu,fra,ita
kaolin	fra,zho
kapel	ita
kapilár	deu,lat
kapitál	deu,ita,lat
kapitán	gmh,lat
kapit	fra,lat
kapl	gmh,lat
kapra	ces
kaps	lat
kapes	lat
kapsl	deu,lat
karafiát	ces
karambol	fra,spa,por
karant	fra
karatel	ces
karat	jpn
karavan	eng
karban	ces
karbanát	deu,fra,ita,lat
karbol	lat
kardan	ita
kardinál	lat
karfiol	ita,lat
kariér	fra,ita,lat
karkul	ces
karmín	deu,fra,lat,ara
karot	deu,fra,lat,ell
kartel	deu,fra,ita
karton	deu,fra,ita
karusel	fra,ita
kastelán	lat
kastr	lat
kašn	deu
kaštan	lat,ell
ká	ces
komb	ita,lat
katan	cat
katarz	ell
katod	eng,ell
kaval	fra,ita,lat
kaviár	deu,fra,ita
kázeň	pol,chu
káž	ces
každ	ces
kbel	lat
kdák	ces
kefír	bul,rus
kel	ces
keramik	fra,ell
kibic	deu
kiks	deu,eng
kimon	jpn
kinemat	fra,ell
kinet	ell
kiosk	deu,fra,ita,tur,pes
klábos	ces
klan	eng
klasik	deu,fra,lat
klasi	fra
klášter	gmh,lat
klat	ces
iád	eng,isl,swe,dan,lat
klaustro	lat
klauzur	lat
kláves	lat
kláv	lat
kleč	ces
klenb	ces
klevet	ces
klih	ces
klíž	ces
klikv	rus
klinik	deu,fra,ell
klisn	ces
klobás	ces
klobouk	ces
klokoč	ces
klokot	ces
klokt	ces
klot	eng
kluč	ces
kluk	ces
klystýr	lat,ell
kmen	ces
kmotř	ces
kniž	ces
knof	gmh
knokaut	eng
knot	gmh
kňuč	lit,deu
kobalt	deu
our	ces
ist	lat
kofein	deu
kokain	spa
kokos	deu,por,fra,lat
kokrh	ces
koks	deu,eng
laud	lat
koléb	ces
koled	ces
kolen	ces
koles	ces
kolibř	fra
kolář	ces
kolo	ces
kolor	ita
komand	deu,ita
mand	fra,lat
kombajn	rus,eng,lat
merc	fra,lat
komet	lat,ell
komfort	eng,fro,lat
komik	lat,ell
komiks	eng
tát	lat
pakt	lat
ple	fra,lat
komplet	deu,fra,lat
komplex	lat
komtur	deu,gmh,fro,lat
koňak	fra
koncept	lat
koncert	deu,ita,lat
konce	lat
koncil	lat
koncipient	lat
končet	ces
denz	lat
konejš	ces
fid	lat
konflikt	lat
jug	lat
konkurs	lat
konop	ces
stern	lat
strukč	lat
konšel	ces
kontinent	deu,lat
kontinu	lat
kont	ita,lat
kontrakt	lat
kontrast	deu,ita,lat
kontribu	lat
kontum	lat
konval	ces
ver	lat
ator	ita
konzist	lat
konzol	deu,fra
konzul	lat
konzult	lat
konzument	lat
kopan	ces
kopt	pol
ráb	ces
rek	lat
korm	rus
koroz	lat
korpul	lat
korpus	lat
korvet	deu,fra,lat
korzár	deu,ita,lat
kořal	pol
kosmet	fra,ell
kosteln	slk,pol
košík	eng
košťál	ces
koteln	ces
kotouč	ces
zkum	ces
kout	ces
kova	ces
ok	ces
kozel	ces
kůzl	ces
luh	ces
krád	ces
krajin	ces
králík	ces
krám	gmh
kram	gmh
krb	ces
kreat	lat
kredit	deu,ita,lat
krep	fra,fro,lat
krevet	fra,lat
kriket	eng,fro,nld
kriz	deu,lat,ell
krn	ces
krok	ces
kroket	eng
krokodýl	lat,ell
krouh	ces
kroup	ces
kruš	ces
krůt	deu
křáp	ces
křen	ces
křes	ces
křest	ces
křišťál	lat
kšeft	deu
kšilt	deu
kučer	ces
kudl	fra,lat
kufř	deu,fra,lat,ell
kujón	deu,fra,ita,lat
kukl	ces
kulis	fra
kulmin	lat
kuloár	fra
kun	ces
kuňk	ces
kupl	deu,fro,lat
kuráž	fra,fro,lat
kurt	eng,fro,lat
kurev	ces
kurv	ces
kurýr	deu,fro,lat
kůž	ces
kvalt	deu
kvedl	deu
inář	ces
kvint	lat
kýč	deu
kyčel	ces
kymác	ces
kypř	fra,lat
kyrys	deu,fro,lat
labil	lat
lac	ces
lakot	ces
lamel	fra,lat
lament	lat
laň	ces
lán	deu,gmh
lan	eng
lano	lat
laparo	ell
laryng	lat,ell
laser	eng
las	ces
lašk	ces
latex	lat
láv	deu,ita,lat
lebed	ces
leda	ces
ledv	ces
legion	lat
legitim	lat
lecht	ces
lesk	ces
le	ces
úl	ces
leuk	ell
lvíč	ces
lez	ces
lhostejn	ces
lic	ces
lig	deu
líh	deu
likér	deu,fra,lat
lik	ces
lilipután	eng
limonád	deu,fra,ita
lip	ces
lísk	ces
lév	ces
litr	deu,fra,ell
liturg	lat,ell
lob	eng
lobb	eng,lat,deu
lodyh	pol,rus
lokaj	fra
lokal	deu,fra,lat
loket	ces
lokomotiv	eng,lat
lomoz	ces
lop	ces
lopot	ces
lotos	ell
loutn	gmh
louž	ces
lucern	lat
lukrat	lat
lulk	ces
lump	deu
lun	ces
lýč	ces
lymf	lat
lýtk	ces
macer	lat
mač	eng
máč	ces
madrigal	ita
mafián	ita
mag	lat,ell,peo
magoř	ces
rádž	eng
máj	lat
majorán	ces
majorit	lat
makléř	deu,dum
malát	gmh,ita,lat
malicher	ces
malt	ita,lat,ell
mamut	deu,rus
mandarín	deu,por,zlm
manekýn	deu,fra,dum
manéž	fra,ita,lat
manipul	fra,frm,lat
mank	ita,lat
manu	lat
manýr	deu,fro,lat
manžet	deu,fra,lat
maraton	ell
marci	deu,ita
margarín	fra,ell
margin	lat
marín	deu,fra,lat
markrab	gmh
markýz	fra,deu
marmelád	deu,fra,por,lat,ell
már	deu
masakr	deu,fra,fro
masér	deu,fra,ara,lat,ell
másel	ces
más	ces
masturb	lat
maš	deu,fra,lat,ell
maškar	ita
mě	ces
med	ces
měd	ces
medail	deu,fra,ita,lat
medailon	deu,fra,ita,lat
medi	deu,lat
mech	ces
mek	ces
melír	deu,fra,fro,lat
měl	ces
meloun	deu,ita,lat
memor	eng,lat
měň	ces
mental	deu,fra,eng,lat
mentol	deu,lat
merit	lat
mesian	lat
urg	ell
meto	lat,ell
mezer	ces
sopr	ita,lat
mhouř	ces
mikro	eng
milion	ita,lat
milit	deu,fra,lat
atur	ita
minim	lat
minister	deu,fra,lat
minorit	deu,fra,eng,lat
mírn	ces
míz	ces
mlk	ces
mls	ces
mlýn	ces
mlyn	ces
mnoh	ces
mód	deu,fra,lat
modelář	deu,fra,ita,lat
mod	deu,lat
modl	prg
mohyl	ces
mokř	ces
moll	lat
molybden	fra,lat,ell
nukle	eng,lat
monu	lat
morál	lat
mord	gmh
morén	deu,fra
morfi	ell
moruš	lat,ell
úmor	ces
mosaz	ces
moskyt	deu,spa,lat
mošt	lat
moudr	ces
moz	deu,fra,ita,lat
aik	deu,fra,ita,lat
mozeč	ces
mozol	ces
mráč	ces
mračn	ces
mrák	ces
mramor	lat
mrd	ces
mrhol	ces
mrch	ces
mrkv	ces
mrň	ces
mrož	rus
mrtv	ces
muk	ces
muml	deu
mus	ces
muskul	lat
muslim	ara
mušl	deu,lat
múz	lat
mýk	ces
smyk	ces
mýl	ces
myrt	deu,lat,ell
myšl	ces
myš	ces
myc	ces
mzd	ces
mžour	ces
nacion	lat
nádher	gmh
dš	ces
nádob	ces
nádor	ces
naiv	deu,fra,lat
máh	ces
mah	ces
rafič	lat,ell
narcis	deu,lat,ell
nárt	ces
ruž	ces
nať	ces
naturál	lat
vig	lat
navštív	ces
negat	lat
horáz	ces
ap	ces
neon	eng,ell
řest	ces
nešt	ces
utr	lat
neutrál	lat
nevrl	ces
bed	ces
nikl	deu,swe
nět	ces
níz	ces
nobles	fra,lat
noč	ces
noet	ell
nomád	lat,ell
noni	por
noř	deu,lat
nostalg	lat,ell,deu
nostri	lat
nouz	ces
nuz	ces
novel	ita,lat
nugát	fra,lat
nutk	ces
nůž	ces
nylon	eng
nymf	lat,ell
ějš	ces
oblač	ces
oblast	ces
léc	ces
loh	ces
obol	lat,ell
oř	ces
obr	ces
ratl	ces
rát	ces
obyčej	ces
ocas	ces
oceán	lat,ell
ofenz	deu,fra,fro,lat
ofici	lat
oh	ces
ohav	ces
hrom	ces
oken	ces
okoun	ces
okr	deu,lat,ell
okres	pol
okrsk	ces
oktan	lat
oligo	ell
olov	ces
olš	ces
melet	fra
onomast	ell
ontolog	ell
pač	ces
opi	lat,ell
plz	ces
ponent	lat
vrž	ces
pt	lat
orl	ces
orchestr	deu,fra,lat,ell
origin	deu,lat
oříš	ces
os	ces
osl	ces
sid	ces
sln	ces
osnov	ces
ostent	lat
oškliv	ces
šul	ces
otál	ces
otč	ces
otc	ces
ote	ces
otroc	ces
ovč	ces
fist	deu,fra,lat
pádl	deu,eng
pahýl	ces
pach	ces
pách	ces
pakl	deu
palác	ita,lat
palisandr	fra,nld
palič	ces
pamat	ces
paměť	ces
panen	ces
pancéř	gmh,fro,lat
panoptik	deu,eng,ell
papr	srp,hrv
paraf	deu,fra,lat
pleg	ell
parašut	fra,lat
parit	lat
parlament	fra,fro,lat
paroh	ces
partner	eng,enm,fro,lat
partyzán	rus,fra,ita,lat
paster	fra
páter	lat
pater	lat
páteř	lat
patricij	lat
patrol	deu,fra
patron	lat
paušál	deu,lat
páv	gmh,lat
pavlač	ces
pavouč	ces
pažit	ces
pec	ces
pedagog	lat,ell
pedál	deu,ita,lat
pedant	deu,fra,ita
pedia	deu,ell
pěch	ces
pekel	ces
pekl	ces
ton	fra,lat
penalt	eng,fra,lat
penicilin	deu,eng,lat
peníz	deu,lat
pentl	gmh
perifer	deu,lat,ell
pes	ces
pest	lat
pestr	ces
piar	lat
píď	ces
piet	lat
pilot	deu,fra,ita,ell
pimprl	deu
pionýr	deu,fra,fro
pipl	ces
písč	ces
písn	ces
píst	ces
piškot	deu,ita,lat
píšť	ces
pišt	ces
pitv	ces
pitev	ces
pivot	eng,fra
pizd	ces
plač	ces
plamen	ces
plápol	ces
plášť	ces
plášt	ces
platan	deu,lat,ell
platin	spa,lat
plátn	ces
pláž	fra,ita,lat
plec	ces
pléd	eng,gla
plem	ces
pleť	ces
plev	ces
ploch	deu
plomb	deu,fra,lat
plosk	ces
plot	ces
plouh	ces
ploutev	ces
plst	ces
pluh	ces
pluž	ces
plurál	lat
plural	lat
plus	lat
plyš	deu,fra,fro,lat
plýtv	ces
pn	ces
pódi	deu,lat,ell
lah	ces
laž	ces
podl	pol
poet	lat,ell
chroum	ces
šev	ces
poji	ces
ker	eng
polar	lat,ell
pól	lat,ell
polár	lat
polk	fra
ester	deu
mer	ell
styren	ell
pomeranč	deu
pomo	lat
ponti	lat
ponton	deu,fra,lat
pór	gmh,lat
porfyr	lat,ell
rouch	ces
slech	ces
spolit	ces
stýl	ces
šet	ces
šram	ces
pošt	deu,ita,lat
ačk	deu,ita,lat
potenc	lat
ši	ces
ťouch	ces
tu	ces
tvůr	ces
poup	ces
poušť	ces
prách	ces
pranýř	gmh,gml
prapor	rus
pré	deu
fabr	deu,lat
prejz	deu
premiér	fra,lat
prestiž	fra,lat
zent	lat
primit	deu,fra,lat
princ	deu,fra,fro,lat
prior	lat
privat	deu,lat
problém	deu,lat,ell
problem	deu,lat,ell
proces	deu,lat
long	lat
promiskuit	fra,lat
pag	deu,fra,lat
roc	ces
sper	lat
prostor	ces
prosť	ces
proton	eng,ell
proto	lat,ell
provinc	lat
pruder	fra,fro,lat
prouž	ces
prout	ces
prýsk	ces
pryskyř	ces
pryž	ces
příď	ces
fař	gmh,lat,ell
příkr	ces
přítel	ces
zračn	ces
pstruh	ces
pšen	ces
pšouk	ces
pštros	gmh,lat,ell
ptač	ces
pták	ces
pubert	lat
publik	lat
public	lat
publ	lat
rys	ces
pukl	ces
puntík	gmh,lat
purkrab	gmh
vab	ces
pyl	rus
pyramid	deu,lat,ell
pýř	ces
pyžam	deu,eng
rabín	lat,heb
radio	deu,fra
raft	eng
ragb	eng
ráhn	deu
rajon	fra,lat
ramp	deu,fra,frk
rámus	ces
rap	eng
rašpl	deu
rati	lat
rázn	ces
raž	ces
realiz	lat
cid	lat
ci	lat
recit	lat
dund	lat
registr	lat
rel	deu,fra,lat
relax	lat
reliéf	deu,fra,lat
relikt	lat
renes	fra,fro,lat
repet	lat
rept	ces
resort	deu,fra,lat
respekt	lat
suscit	lat
rétor	lat,ell
rever	lat
end	lat
revír	deu,gmh,fro
volt	deu,fra,ita,lat
revolver	eng,lat
rezist	lat
rezon	lat
zon	lat
režis	fra,lat
ribstol	swe
rigid	lat
ring	eng,deu
rituál	deu,lat
rival	deu,fra,lat
rizik	deu,ita
rmout	ces
rohož	ces
roj	ces
rop	pol
rotn	gmh,fro,lat
rour	gmh
stář	ces
rovník	ces
marýn	deu,lat
ptýl	ces
šaf	deu
rubín	deu,fro,lat
ruin	deu,lat
ruměn	ces
run	deu,got,isl
rybíz	deu,ita,lat,ara,pes
ryp	ces
ryš	ces
ryz	ces
říč	ces
řetíz	ces
řež	ces
říc	ces
říh	ces
sáčk	lat,ell,sem
sáč	lat,ell,sem
sádl	ces
safír	gmh,lat,ell,heb
ság	deu,isl
sak	ces
salám	ita,lat
salát	deu,gmh,ita,lat
salicyl	lat
salmonel	lat
samet	deu,fro,lat
sandál	deu,lat,ell,pes,egy
sankc	deu,fra,lat
sapo	lat
sardel	deu,ita
satelit	lat
satén	fra,ara,zho
sax	fra
segment	deu,lat
sektor	deu,lat
sekyr	ces
selen	lat,ell
semestr	deu,lat
semiš	deu,fra,lat
sen	ces
senát	lat
senzor	eng,fra,lat
sépi	lat,ell
seri	eng
séri	deu,lat
serióz	deu,fra,lat
sér	deu,lat
servil	deu,lat
serv	deu,fra,lat
sext	lat
schizo	ell
sídl	ces
signal	deu,fra,lat
siláž	deu,fra,spa
silikon	lat
simpl	lat
síň	ces
sin	ces
singl	eng,fro,lat
sír	ces
siřič	ces
sirot	ces
sirup	ces
skalp	eng
skand	deu,lat,ell
skandal	deu,lat,ell
skaut	eng,fro,lat
skept	deu,ell
sklíč	ces
sklář	ces
skob	ces
skořic	ces
skot	ces
skreč	eng
skříň	lat
skuteč	ces
sláb	ces
slalom	nor
slal	nor
slam	ces
slan	ces
slast	rus,chu
smaragd	lat,ell
smetan	ces
smil	ces
smog	eng
smrk	ces
smůl	ces
smyč	ces
sňat	ces
sněh	ces
snop	ces
snow	eng
sobot	ces
sój	deu,jpn
somr	deu
sopeč	rus,orv
sos	deu,fra,lat
sosn	ces
souk	ces
struž	ces
soutěž	ces
souž	ces
už	ces
sov	ces
spár	ces
spektr	lat
spekul	lat
sperm	lat,ell
spíl	ces
spontán	lat
spraš	ces
sprint	eng
sprinter	eng
squash	eng,fro,lat
srp	ces
srš	ces
stád	ces
kok	ell
stagn	lat
stáj	ces
stál	ces
standard	eng,fro,lat
stand	eng,fro,lat
stáž	fra,lat
stěh	ces
stejn	ces
stén	rus
ster	deu,fra,lat
stiž	ces
stipend	lat
stopař	eng
storn	ita,lat,ell
přestup	ces
strak	ces
strán	ces
stres	eng,fro,lat
strk	ces
strm	ces
stroh	rus,deu,nor,lit
strop	ces
struč	ces
strusk	ces
střád	ces
střeh	ces
střevl	ces
stříbr	ces
stříbř	ces
střídm	ces
stříc	ces
lim	lat
skrip	lat
til	lat
such	ces
sulc	deu
sultán	tur,ara,arc
supl	deu,lat
suterén	fra,lat
važ	ces
sval	ces
svěd	ces
svíčk	ces
sviň	ces
svůd	ces
sýkor	ces
sýp	ces
sýr	ces
sysl	ces
systol	lat,ell
šacht	deu
šakal	deu,fra,pes
šalt	deu,gmh
šampion	fra,lat,deu
šampon	deu,eng
šanson	fra,lat
šantán	fra,lat
šát	deu
šátr	ces
šek	deu,eng,fro,pes
šelest	pol
šelm	gmh
šenk	gmh
šerif	eng,ang
šerm	gmh
šermíř	gmh
šešul	ces
šetr	ces
šid	ces
šíj	ces
šikan	deu,fra
šikm	gmh
šimpanz	deu
šindel	gmh
šin	lat
šíp	ces
šipk	ces
šišl	ces
škebl	ces
škraloup	ces
škud	ces
šlechet	gmh
šluk	deu
šmajd	ces
šmak	deu,deu
šmejd	deu
šmír	deu
šmouh	ces
šmudl	deu
šnek	deu
šňoř	deu
šouf	deu
šour	ces
špás	deu,ita,lat
šped	deu,ita,lat
špeh	gmh,eng,lat,ell
špejl	deu
špenát	deu,ita,spa,ara,pes
špendl	gmh,lat
špit	ces
šplích	ces
šprt	ces
šraf	deu,ita
štáb	deu
štafet	deu,ita
štafl	deu
štědr	ces
štěn	ces
štep	deu
štěrbin	ces
štěrk	ces
štěst	ces
štír	ces
štíř	ces
štít	ces
šťour	deu
štrach	ces
šum	ces
šunk	deu
šušk	ces
šutr	deu
šv	ces
švagr	deu
švehol	ces
švenk	deu
švitor	deu
švorc	deu
tabák	deu,spa
tablet	deu,fra,lat
tabu	deu
taft	deu,ita,frm,pes
tacho	ell
tamaryš	lat
tandem	deu,eng,lat
tang	spa
tap	deu,lat,ell
tartan	eng
tašk	goh
teatr	deu,lat,ell
tečk	ces
teflon	eng
tehd	ces
ěhoten	ces
tejp	eng,ang
telet	ces
temper	ita,lat
tempera	deu,lat
templář	lat
tenis	eng,enm,fra,lat
tenist	eng,enm,fra,lat
terakot	ita,lat
terap	deu,ell
terč	gmh,fro,deu,ang,deu
terén	fra,lat
tesil	ces
tetra	lat,ell
tchoř	ces
tíh	ces
titan	lat
titán	lat
titěr	ces
tmel	ces
toalet	fra,fro,lat
toast	eng,fro,lat
topo	ell
topoř	ces
torpéd	deu,eng,lat
tož	rus
toul	ces
trafik	deu,ita
éd	lat,ell
trajd	ces
transkrip	lat
trať	gmh
tre	eng,nld
trek	eng,nld
tref	gmh,deu
trepan	lat,ell
trezor	deu,fra,lat
angul	lat
tribun	ita
trikot	fra,fro,deu
trk	ces
troš	ces
troch	ces
trochej	lat,ell
trouch	rus
truchl	ces
trycht	deu,lat
trojk	ces
tříšt	ces
třtin	ces
tul	deu,lat,tur
tun	lat
turbín	deu,fra,lat
turnaj	gmh,fro,lat
tut	ita,lat
tvaroh	ces
tvíd	eng
tvrz	ces
tým	eng,ang
tymi	gmh,lat,ell
tyrkys	deu,fra
nav	ces
unik	deu,lat
únor	ces
urban	fra,lat
urn	lat
uro	ell
utilit	eng,fra,lat
utilitar	eng,fra,lat
útl	ces
uzd	ces
úž	ces
vág	deu,fra,lat
vagon	deu,eng,dum
valut	deu,ita,lat
varhán	lat,ell
abil	lat
vart	gmh
varn	ces
vavřín	pol,lat
vdol	ces
večeř	ces
vaječ	ces
věj	ces
velbloud	ces
velter	eng
velur	fra,fro,lat
veri	lat
vertik	lat
vísk	ces
vesmír	rus
věš	ces
větv	ces
vever	ces
vik	lat
víkend	eng
vikl	gmh
vín	ces
vinš	deu
vir	lat
virbl	deu
viróz	lat
virt	lat
višň	ces
vitamin	lat
vlad	ces
vlaj	ces
vlajk	ces
vlákn	ces
vlá	rus,chu
vleč	ces
vlídn	ces
vlk	ces
vnějš	ces
nitř	lat
vnouč	ces
vos	ces
vražed	ces
vratk	ces
vrč	ces
vrstev	ces
vřed	ces
vřešt	ces
vstříc	ces
všedn	ces
vůl	ces
vulgár	deu,lat
vulgar	deu,lat
výs	ces
vyz	ces
vzácn	ces
dor	ces
vzduš	rus
neš	ces
watt	eng
smuš	ces
zvor	ita
braň	ces
dviž	ces
nář	deu,fra
zeman	ces
zink	deu
zisk	ces
zlát	ces
zmij	ces
zón	lat,ell
zurč	ces
zvěř	ces
zvuč	ces
žalud	ces
žampion	fra,lat
žánr	fra,lat
ždib	ces
ždím	ces
židl	ces
žiraf	ita,ara
žízn	srp
žláz	ces
žluk	ces
žold	gmh,fro,lat
žonglér	deu,fra,fro,lat
žuch	ces
a	ces
a-2	ell
ab-	lat
abatyš	lat,ell,arc
abb	fra,lat
ablautový	deu
ablaut	deu
abon	deu,fra,fro
abrakadabra	lat
brevi	lat
brup	lat
absces	lat
absent	lat
sent	lat
absenc	lat
absint	fra,lat,ell
absolutori	lat
absorpc	lat
sorb	lat
abstenc	eng,fra,lat
tinenc	lat
tinent	lat
aby	ces
acetát	lat
acet	lat
aceton	lat
acid	lat,ell
acyl	lat,ell
ač	ces
ad-	lat
adamit	lat
adapt	lat
adaptovat	lat
adept	lat
adié	fra
adjunkt	deu,lat
justac	lat
adjustovat	lat
administrativa	lat
administr	lat
administrac	lat
admiral	deu,fra,ara
admirál	deu,fra,ara
adolescenc	lat
adonis	ell
adopc	lat
adopt	lat
ador	lat
adrenalin	lat
adverbi	lat
advokac	lat
aero-1	lat,ell
aero-2	ell
aerob	eng,ell
afáz	ell
afekt	lat
afér	fra,lat
afor	lat,ell
afrik	lat
frodiz	lat,ell
aft	lat,ell
agáv	lat,ell
agend	lat
agil	lat
aglomer	lat
agr	lat
agreg	lat
agresor	lat
agro-	ell
agro	deu,fra,ell
aha	ces
ahoj	eng
air	eng
aj	eng,lat,ell
ajnc	deu
znb	deu
akát	lat,ell
akcelerace	lat
akcentuace	lat
akcent	lat
cept	lat
akcion	deu,nld,lat
akn	lat,ell
modač	lat
modac	lat
akorát	deu,lat
akord	fra
akordeon	fra,deu
akr	eng,ang,deu,lat,ell
aksamit	lat,ell
aksam	lat,ell
aktér	fra,lat
aktiv	lat
aktuál	lat
akurát	deu,lat
akut	lat
akuz	lat
akva	deu,lat
akvalung	eng,lat
akvamarín	deu,lat
akvarel	deu,fra,ita
akvarij	lat
akv	lat
akvizice	deu,lat
alabastr	lat,ell
alarm	deu,ita,lat
albatros	eng,spa,por
albin	spa,por,lat
albín	spa,por,lat
alb	deu,lat
aldehyd	lat
ale	ces
alegor	lat,ell
alej	deu,fra,lat
aleluja	lat,heb
alespoň	ces
alexandrin	fro
algebraick	lat,ara
algebr	lat,ara
algoritm	lat,ara
alianc	fra,lat
alias	lat
alibi	lat
aligátor	eng,spa,lat
alk	nor
alkaloid	lat,ara
alkalick	lat,ara
alkovn	deu,fra,spa,ara
alman	deu,lat
almar	lat
almuž	gmh,lat,ell
aloe	lat,ell
alotria	deu,ell
alou	deu,fra,lat
altist	ita,lat
altru	fra,lat
amant	fra,lat
amazonk	lat,ell
ambasád	fra,ita,lat
ióz	lat
ambróz	ell
ambulant	fra,lat
ambulanc	fra,lat
améb	lat,ell
amen	lat,ell,heb
ametyst	lat,ell
amfi	lat,ell
amfor	lat,ell
amok	eng,zlm
amolet	fra
amoniak	lat
amorek	lat
amor	lat
amorál	lat
amorf	ell
ampér	fra
amplion	eng,fra,lat
amplitud	lat
ampul	lat
amput	lat
amul	lat
adv	ell
ana-	ell
anabolika	eng
anagram	lat,ell
anakolut	ell
analf	lat
analgetik	lat,ell
anál	lat
anamnéza	ell
ananas	por
tomic	lat,ell
andíl	ces
android	ell
andul	lat
nekt	lat
aném	lat,ell
nestet	ell
stéz	ell
anex	lat
gaž	fra
angažm	fra
angrešt	it,lat
anilin	por,ara,pes
animozit	lat
anket	fra,lat
anod	ell
anom	lat,ell
anomál	lat,ell
anoncovat	fra,lat
anon	fra,lat
anonym	lat,ell
anot	lat
ámbl	fra
ansámbl	fra
anšovič	deu
ante-	lat
antén	lat
anti-	ell
anticipac	lat
antic	deu,fra,lat
antika	deu,fra,lat
koncepc	lat
kv	deu,lat
antikv	deu,lat
kvariát	deu,lat
antilop	fra,eng,lat,ell
antolog	lat,ell
antonym	ell
antrac	lat,ell
antropo-	ell
anýz	gmh,lat,ell
aor	ell
aort	lat,ell
aparát	lat
apartheid	nld
apartm	fra,ita,lat
apart	deu,fra,lat
apatyk	lat,ell
apel	fra,lat
apendix	lat
aperit	fra,lat
apet	deu,fra,lat
aplaus	lat
aplaud	lat
apo-	ell
kalyps	lat,ell
kryf	lat,ell
apoz	lat
probac	lat
apsid	lat,ell
ar	fra,lat
arabesk	deu,fra,ita
arak	fra,ara
aranžm	fra
aranž	fra,deu
naaranžovat	fra,deu
ranž	fra,deu
arbitr	fra
arci-	lat,ell
areál	lat
arén	deu,lat
argon	ell
argot	fra
argu	lat
argument	lat
aršík	gmh,lat
archaic	deu,lat,ell
archa	deu,lat,ell
archanděl	lat
archi-	ell
arkhitektura	lat,ell
árij	deu
árijec	deu
arkád	fra,ita,lat
arkebuz	deu,fra,deu
arkýř	gmh,fro,lat
armat	deu,lat
arogant	lat
aroganc	lat
arte	lat
artér	lat,ell
artikl	deu,lat
artiler	deu,fra,fro
artróz	lat,ell
artyčok	ita
rytmi	lat,ell
arzén	lat,ell
arzenál	ces
asan	deu,fra,lat
asert	eng,lat
asertiv	eng,lat
asfaltk	lat,ell
asi	ces
sist	deu,lat
skez	deu,ell
ason	lat
asparágus	lat,ell
aspekt	lat
aspik	fra
spirát	lat
aspirin	deu
aspoň	ell
aster	ell
astm	lat,ell
astro-	ell
ať	ces
atak	fra,ita
atakovat	fra,ita
ataman	ukr,rus
ataš	fra,ita
ateliér	fra,fro,lat
atent	deu,fra,lat
atentát	deu,fra,lat
atlas2	deu,ara
atmo	ell
atol	eng
atribut	lat
atri	lat
trof	ell
aťsi	ces
audienc	lat
audio-	deu,fra,lat
aukč	deu,lat
aukc	deu,lat
aureol	lat
auš	deu
autent	lat,ell
autentic	lat,ell
auto-1	fra,lat
auto-2	ell
daf	por,lat
chton	ell
autorit	lat
avant	fra
avantýr	fra,lat
averz	lat
avokád	spa
avšak	ces
axiom	lat,ell
azal	lat
azim	fra,ara
babsk	ces
babk	ces
baboč	rus
babyk	ces
bác	ces
bacul	ces
bač	ron
bačkora	hun
badyán	fra,pes
baganč	slk
bagatel	fra,ita
bagat	fra,ita
bagáž	fra,fro
baget	fra,ita,lat
bágl	ces
bah	ces
bahen	ces
bach	deu
bachor	ces
báchor	ces
bachr	ces
bachyn	deu
bajonet	deu,fra
baklažán	rus,tur,ara,pes
bakš	tur,ara,pes
bakteri	ell
bakterio	ell
bakter	ell
baladick	deu,fra,lat
balad	deu,fra,lat
balalajk	rus
balamuc	ces
balamut	ces
lanc	fra,lat
balanc	fra,lat
balast	deu,nld
baldachýn	deu,ita
baldrián	gmh,lat
balerín	deu,ita,lat
balík1	deu
balík2	deu
-ball	eng
balo	ces
balustrád	fra,ita,lat,ell
balz	spa
balzam	lat,ell
balzám	lat,ell
bambit	ces
baňk	slk
baňat	slk
báňsk	slk
báň	slk
banal	deu,fra,fro,deu
banál	deu,fra,fro,deu
baná	deu,spa,por
banč	ces
bančit	ces
bandur	hun
banj	eng
banket	deu
bao	ara
baptist	lat,ell
bar1	eng,fro
bar2	ell
barabizn	deu,fra,spa
barbiturát	ita
bard	deu,fra
barel	eng,fro
baret	fra,ita,lat
barchet	deu
bariér	fra
bariéra	fra
bárk	ces
baronet	deu,fra,fro,lat,deu
barones	deu,fra,fro,lat,deu
bartrový	eng,fro
barba	gmh
barvín	gmh,lat
baryt	fra,ell
bary	eng,ell
báseň	rus
basketbalistický	eng
basreliéf	fra
basta	ita,lat,ell
bastard	deu,fro
bašta1	ita,deu
bašta2	ces
bát se	ces
batalion	deu,fra,ita,lat
bater	fra,fro,lat
batoh	ces
batolit se	ces
batyskaf	fra,ell
baux	fra
bavlnk	deu
bavlník	deu
bazalk	lat,ell
bazalt	deu,lat,ell
bazál	deu,lat,ell
bá	ces
baziliš	lat,ell
bazil	lat,ell
baz	deu
baž	ces
bd	ces
beat	eng
bečk	ces
běd	ces
bedekr	deu
bedýn	deu,lat,ell
beder	ces
begon	lat
bek	eng
bekyn	gmh,fra
bendžový	eng
bendžist	eng
bendž	eng
benedikt	lat
benefič	lat
benefic	lat
bengál	eng
benig	lat
benzen	spa,ara
benzol	spa,ara
berán	ces
beránč	ces
beruš	ces
beryl	lat,ell
běsn	ces
besíd	ces
besemer	eng
besemerace	eng
besti	lat
bestial	lat
sell	eng
betel	por
betl	deu
betonárn	fra,fro,lat
betonár	fra,fro,lat
bezový	ces
bez1	ces
bez2	ces
bezděk	ces
priz	rus
běhoun	ces
bíh	ces
biec	ces
biegać	ces
bežáť	ces
bjèžati	ces
běžati	ces
béž	fra,fro
bi-	lat
bíbr	deu
ceps	lat
bid	fra
bidl	ces
bienál	lat
biftek	eng
bigam	lat,ell
bigamie	lat,ell
bigot	fra
bilanč	deu,ita,lat
bilanc	deu,ita,lat
bilion	fra
rubin	lat
bill	eng
ás	ces
bimb	deu
bin	lat
binec	ces
bing	eng
bio-	ell
biret	lat
biřic	ces
biskv	fra,lat
bistr	fra
bit	eng
bitk	ces
bitv	ces
bitev	ces
nabíječ	ces
bić	ces
biť	ces
̏ti	ces
biti	ces
bizam	deu,lat,heb
bíz	ces
-bízet	ces
bižuteri	fra
blaho	lat,ell
blamáž	deu,fra,lat,ell
blánovitý	ces
blankvers	eng
blázínek	ces
blázin	ces
blázen	ces
blaze	fra
blbin	ces
bledul	ces
blešk	ces
blech	ces
blejzr	eng
blín	ces
bli	ces
nk	ces
blinkr	deu
blivajz	ces
blí	ces
blizard	eng
bližní	ces
blizn	pol
bloč	deu
blokád	deu,fra,nld
blonď	fra,lat,deu
blond	fra,lat,deu
bloum	ces
blum	gml,lat,ell
blyšt	ces
boa	lat
bobk	ces
bob1	ces
bob2	eng
bobř	ces
bobr	ces
bobtn	ces
bodl	ces
bodejť	ces
atl	ces
bohém	fra
bochán	gmh,lat
ů	ces
bojar	rus
bojler	eng,fro,lat
bůč	ces
bok	ces
bolíst	ces
bolševic	ces
bombardon	fra
bombardér	fra
bombard	fra
bombast	deu,eng,lat,ell,xmn
boni	lat
bonmot	deu,fra
bonsaj	jpn
bonton	fra
bonv	fra,lat
bonzák	deu,fra,por,jpn
bonz	deu,fra,por,jpn
book	eng
boom	eng
bór	ces
borax	deu,lat,ara,pes
bord	fra
borelióz	lat
boršč	rus
bort	deu
bosor	tat
boss	eng,nld
bosy	ces
bos/bosój	ces
bôs	ces
bosъ	ces
bos	ces
botový	fra,lat
botanick	deu,lat,ell
botel	eng
botul	lat
boub	ces
bouch	ces
bovd	eng,fra
bowl	deu,eng,ang,fra
bowling	eng,fra,lat
box1	eng
boxer	eng
boxerky	eng
box2	eng
bradatice	ces
brada	ces
bradla	ces
bráh	eng
brách	ces
brach	ces
brajgl	nld
brak	deu
brambůr	ces
brambo	ces
bramb	ces
řišt	ces
brandy	eng,nld
brány	ces
branž	fra,lat
bír	ces
obrat	ces
brać	ces
brať	ces
brȁti	ces
bьrati	ces
bratř	ces
bravur	ita,lat
bravo	ita,lat
brbl	ces
brd	ces
brebent	ces
bréc	ces
brek	ces
brejk	eng
brepta	ces
breviář	lat
brhlík	ces
bridž	eng
brífink	eng,fro,lat
brigádn	deu,fra,ita
brig	eng,ita
brigantina	eng,ita
briket	fra,dum
brilant	deu,fra
brili	deu,fra,ita
briliant	deu,fra,ita
briošk	fra,deu
bríz	deu,eng,fra
brčk	ces
brloh	rus
brňavk	ces
brojler	eng,fro
bro	ita
bronch	lat,ell
bronto	ell
broskvoň	lat
broskev	lat
brousek	ces
brusk	ces
brusn	ces
brusi	ces
brovn	eng
brožur	fra
brslen	ces
brtník	ces
brukev	pol
bruml	ces
brundib	deu
brusink	ces
brutal	lat
brutál	lat
brutto	ita,lat
brv	ces
bryčk	pol,deu,ita,lat
brykul	fra
brýlat	deu,gmh
brýl	deu,gmh
bryndák	ces
bryndáč	ces
brynz	ron
bryskn	fra,ita
brzdn	ces
brzy	ces
brzo	ces
břečk	ces
-břednout	ces
břehule	ces
břeh	ces
břem	ces
břeskn	ces
břevn	ces
březn	ces
bříd	ces
bříš	ces
břin	ces
břit	ces
břitv	ces
bubák	deu,eng
bubín	ces
ínk	ces
bucl	ces
buclat	ces
buďto	ces
buď	ces
budu	ces
buf	fra
bůž	ces
bůh	ces
buchar	deu
bujar	ces
bujon	fra,lat
bouč	ces
bukv	ces
buka	ces
bukanýr	deu,fra
buket	fra
bukl	fra,lat
bukolic	lat,ell
buldoč	eng
buldok	eng
buldo	eng
zerist	eng
buldozer	eng
bulík	deu
bulim	lat,ell
buliž	rus
bulletin	fra,fro,lat
bulv	pol
bum	ces
bumb	ces
bumer	eng
bungal	eng
bunič	ces
buněč	ces
bun	ces
buňk	ces
bunkr	deu,eng
bůr	deu
burák1	deu
burák2	pol
burč	ces
burnus	deu,fra,lat
bursk	deu
buřin	ces
buřtík	deu
buřt	deu
bust	fra,ita
butel	fra,lat
butik	fra,ell
buton	fra
buzar	fra,lat
buzer	deu,ita,lat
buzerant	deu,ita,lat
bych	ell
býk	ces
byst	fra,ita
bystrost	ces
bystr	ces
byť	ell
być	ces
byti	ces
byznys	eng
bzd	ces
bzukot	ces
bžund	ces
các	ces
cacht	ces
cál	deu
camr	ces
canc	ces
candát	ces
capart	ces
cáp	ces
carevn	rus,orv
carevič	rus,orv
carsk	rus,orv
causa	lat
causer	fra,lat
cec	ces
cedník	ces
cedzić	ces
cedíť	ces
cijéditi	ces
céditi	ces
cěditi	ces
cedr	lat,ell
cejn	gmh
cek	ces
celebr	lat
celibát	lat
cembal	ita,lat
cemb	ita,lat
cemr	deu
cená	ces
cijèna	ces
cěna	ces
cent1	lat
cent2	lat
centi-	fra,lat
cenzor	lat
cep	ces
cepen	ces
cepín	slv,ita,lat
cereál	lat
cerebr	lat
ceremoni	fra,lat
ceremoniál	fra,lat
cesi	lat
cesm	srp,hrv
cestující	ces
pocestný	ces
césta	ces
-cet	ces
cetk	srp,chu
cézur	lat
cibet	ita,lat,ara
cídit	ces
cifer	deu,lat,ara
cifr	deu,lat,ara
ciheln	gmh,lat
cihlář	gmh,lat
cích	gmh,lat,ell
cikád	lat
cikcak	deu
cikor	deu,lat,ell
cimb	lat,ell
cimbuř	gmh,lat,ell
cimprl	deu
cimr	deu
cinkot	ces
cirát	deu
cirka	lat
cirk	lat
cirkusák	deu,lat,ell
cirok	lat
ciróza	lat,ell
cisterc	fra
cistern	lat,ell
cister	lat,ell
citer	deu,lat,ell
souci	ces
cútiti	ces
citro	deu,ita,lat
civ	ces
cizelér	fra,fro,lat
cizel	fra,fro,lat
cizák	ces
cizác	ces
cizot	ces
clav	lat,ell
ichord	lat,ell
clán	ces
15.st.	ces
cloum	ces
cmrnd	ces
co	ces
coca-cola	spa
copán	deu
copy	eng
right	eng
crčivý	ces
crč	ces
cicati	ces
cuclati	ces
necudný	ces
cuket	ita
cukř	gmh,ita,ara
zucchero	gmh,ita,ara
sukkar	gmh,ita,ara
cukrkandl	deu,lat
cuml	ces
cupit	ces
cupan	deu
cvál	ces
cval	deu
cvičky	deu
rozcvičk	deu
cv	deu
cvikr	deu,fra
cvoč	gmh
cvok	gmh
cvrč	ces
cvrk	ces
cvrček1	ces
cvrček2	deu
cvrlik	ces
cyank	lat,ell,ara
cyklon	eng,ell
cylindr	deu,lat,ell
cynick	lat,ell
cyst	lat,ell
cyto-	lat,ell
cyto	ell
statik	ell
-č	ces
čabajk	hun
čabr	tur
čac	ces
čač	spa
čachry	deu,heb
čachr	deu,heb
čajíček	rus
čák	ces
čakan	ces
čalamád	hun
čamara	pol,spa
čamrd	ces
čaro-	ces
přesčas	ces
čatni	eng
čau	ita
čečetk	ces
čehý	deu,fra
Čes	ces
Čech	ces
čejk	ces
čelád	ces
čeled	ces
čeleď	ces
čelisť	ces
čelenk	ces
emeř	ces
čen	ces
čepelk	ces
čepel	ces
čerchmant	deu
čerch	ces
čermák	ces
čerň	ces
černoš	ces
červík	ces
červíč	ces
červn	ces
červeň	ces
červánky	ces
čeřen	ces
pačes	ces
czesać	ces
česáť	ces
čèsati	ces
česati	ces
česnečk	ces
čéš	ces
če	srp,hrv,tur,ara
vap	srp,hrv,tur,ara
či	ces
čibuk	ces
čičor	ita,lat
čih	ces
činč	spa,lat
činel	ita
činitel	ces
czynić	ces
činíť	ces
čìniti	ces
činiti	ces
činžák	gmh,lat
čip	eng
čipera	ces
čiperk	ces
čiper	ces
čírk	ces
čirův	ces
čistič	ces
czysty	ces
čístyj	ces
̏st	ces
čistъ	ces
čidl	ces
-čít	ces
čiv	ces
číž	ces
čižm	tur
člověk	ces
čmelík	ces
čmelák	ces
čmouh	ces
čmýr	ces
ěl	ces
čolek	pol
čouh	ces
čpav	ces
čtr	ces
čtveryl	fra,spa,lat
čtvrtk	ces
čubrn	ces
čuč	mkd,pol
čuft	srp,hrv,tur,pes
čumák	ces
čumend	ces
čundračk	deu
čunč	ces
čupr	ces
čupřin	pol,rus
čůr	ces
načutnout	eng
čutor	ron
čůz	deu
čvachtan	ces
čvách	ces
čvacht	ces
dab	eng
dabing	eng
dad	fra
dách	ces
dalaj	mon
dalamán	fra
dálk	ces
dáln	ces
dálava	ces
daleki	ces
dalëkij	ces
dàlek	ces
dalekъ	ces
dám	deu,fra,lat
dáma1	deu,fra,lat
dáma2	deu,fra
daněk	fra,ita,gmh,lat
dard	ces
darebác	ces
daremn	ces
↑dar	ces
dař	ces
ďas	ces
dásň	ces
dáseň	ces
dávat	ces
vk	ces
dá	ces
vdavky	ces
výdej	ces
prodej	ces
dać	ces
dať	ces
dȁti	ces
dati	ces
dát	ces
datel	ces
dativ	lat
datac	lat
datum	lat
dávno	ces
dávn	ces
dcerk	ces
dceř	ces
de-	lat
dealer	eng
debakl	fra
debi	lat
bre	hun
brec	hun
debutant	fra
buž	fra
deci-	fra,lat
deseti	lat
decimál	lat
decimac	lat
decim	lat
děc	ces
dedik	lat
fenestr	lat
defét	fra,lat
defilé	fra,lat
degustér	lat
degust	lat
deht	lit
dehet	lit
výd	ces
dečk	gmh
dekad	fra,lat
deka	fra,ell
děka	lat
dekl	deu
deklam	lat
klamát	lat
dekoltáž	fra,lat
dekolt	fra,lat
dekret	deu,lat
deleg	lat
delfín	deu,lat,ell
delikát	fra,lat
delikvent	deu,lat
delikt	deu,lat
liri	deu,lat
dělitel	ces
delší	ces
podél	ces
dé	ces
dělož	ces
delt	ell
démant	deu,fra
demarš	fra
dement	lat
demenc	lat
dementovat	fra,lat
demis	fra,lat
demiurg	lat,ell
demižon	eng,fra
kra	ell
molič	deu,lat
monstrat	lat
monstrant	lat
denár	lat
nunci	deu,lat
nunciant	deu,lat
nunc	deu,lat
odorant	eng,lat
peš	fra,lat
depil	lat
dep	fra,lat
depoz	lat
depozit	lat
dept	ces
deput	lat
derat	fra
riv	lat
dern	fra
-desát	ces
desater	ces
dest	ces
kriptiv	deu,lat
krip	deu,lat
kript	deu,lat
despekt	lat
desper	lat
despotic	ell
despot	ell
déšť	ces
děti	ces
deuteri	ell
devát	ces
devate	ces
deva	ces
devater	ces
devět	ces
deviant	lat
devi	lat
devíz	fra,lat
devon	eng
dezerc	fra,lat
zert	fra,lat
dezolát	deu,lat
di-1	ell
dia-	ell
diad	lat,ell
diákon	lat,ell
diamant	deu,fro,lat,ell
dianetic	eng,ell
dianet	eng,ell
diář	lat
diaterm	ell
diblík	ces
diecéz	lat,ell
dieta1	deu,lat,ell
dieta2	lat
diftong	lat,ell
difúz	lat
digest	lat
digit	eng,lat
diglosi	ell
digres	lat
dicho	ell
dík	goh
braz	rus
dikta	eng
dilat	lat
dilem	lat,ell
diluv	lat
dimenz	lat
dinár	lat
dino	ell
saurus	ell
dioptric	ell
dioptr	ell
diplomac	fra
diplomat	fra
diptych	lat,ell
rigent	deu,lat
dis-	lat
disciplin	lat
disciplín	lat
disent	eng,lat
disert	lat
disident	lat
disid	lat
disket	eng
krepanc	deu,lat
krim	lat
diskurs	lat
diskut	lat
diskutabil	lat
dison	lat
dispeč	eng,spa
dispečer	eng,spa
dispens	lat
plej	eng,fro,lat
disput	lat
distichon	lat,ell
ingv	fra,lat
disting	fra,lat
inkc	lat
distorz	lat
distrikt	lat
díško	fra
šputát	lat
dít	ces
dít se	ces
dítě	ces
divan	fra,tur,pes
divergent	lat
divergenc	lat
dividend	deu
divis	lat
divizn	ces
divož	ces
díž	ces
dlah	ces
dlan	ces
dlask	ces
dlaž	ces
dle	ces
dlé	ces
atán	ces
dmych	ces
dnes	ces
do	ces
dobytek	ces
docentur	lat
dog	eng
dojen	ces
dojn	ces
dok	eng,deu
kavad	ces
kořán	ces
doktorand	lat
dokud	ces
doku	lat
-dolat	ces
dolič	ces
dolmen	bre
dolomit	fra
dóm	deu,fra,ita,lat
domácí	ces
domén	deu,fra,lat
dominik	lat
donac	lat
donchuán	spa
dop	eng
dorz	lat
spí	ces
dospělý	ces
dosti	ces
dost	ces
šk	gmh
tač	lat
dot	lat
dotac	lat
ďoub	ces
doubrav	ces
douf	ces
doup	ces
ďour	ces
douš	ces
doyen	fra,lat
dóz	deu
doze	lat,ell
dóž	ita,lat
dóže	ita,lat
dráb	ces
drab	deu
dráž	ces
drachm	ell
drajv	eng
drand	ces
dranž	deu,fra
drápavý	ces
draper	fra
drastic	deu,fra,ell
drát1	ces
drát2	ces
drbn	ces
drdol	ces
drek	deu
dren	fra,eng,ang
drezín	deu
drez	deu,fra,lat
drezur	deu,fra,lat
zádrhel	ces
drch	ces
dril	deu
drink	eng
drmoliv	ces
drndavý	ces
drnd	ces
drobek	ces
drobeček	ces
drobet	ces
droger	deu,fra
↑autodrom	ell
kosmodrom	ell
-drom	ell
dromedár	lat,ell
drop	ces
drops	eng
drozd	ces
drožď	ces
drožd	ces
drsn	ces
dršťk	ces
družba	ces
druh1	ces
druh2	ces
druhd	ces
druhý	ces
druid	lat
drv	ces
dryád	ell
dryáčnic	lat,ell
dryák	lat,ell
držák	ces
držav	ces
výdrž	ces
dzierżeć	ces
deržáť	ces
dr`žati	ces
drъžati	ces
dřeň	ces
dřevák	ces
drzewo	ces
dérevo	ces
drêvo	ces
dřez	ces
dřík	ces
dřín	ces
dřišťál	ces
dřin	ces
dříč	ces
drzeć	ces
drijéti	ces
dréti	ces
nejdříve	ces
dšt	ces
dtt	ita,lat
dóvtip	ces
dómyslný	ces
dů-	ces
dual	lat
duben	ces
dubin	ces
doub	ces
dubn	ces
dublet	deu,fra,lat
dubl	eng
dudl	ces
duel	fra,lat
duet	ita
duchovní	ces
duká	ita,lat
dolík	ces
doln	ces
důl	ces
dům	ces
zádum	pol,rus
dumdum	eng
duml	ces
důr	ces
durd	ces
durch	deu
durman	rus
dutin	ces
dvojí	ces
dvojk	ces
dvór	ces
dvůr	ces
dyftýn	fra
nedýchatelný	ces
dychać	ces
dýchaty	ces
díhati	ces
dychati	ces
dýk	gmh,fra
dym	ces
dymi	gmh,lat,ell
dýň	ces
dýn	ces
dýnk	ces
negativního	ell
dys-	ell
dysfem	ell
dyslex	ell
dýz	deu
džajvový	eng
džajv	eng
džber	lit
džem	eng
džez	eng
džin1	eng,fra,lat
džin2	ara
džínsy	eng
džín	eng
džíp	eng,pol
džiu-džitsu	eng,jpn
džob	eng
džud	eng,jpn
džungl	eng
džunk	eng
džuv	srp,hrv,tur
bonit	eng,lat
ecu	eng
edém	lat,ell
eden	heb
edic	lat
edikt	lat
efekt	lat
efe	deu,ell
mér	deu,ell
efervescent	lat
egal	fra,lat
ego	fra,lat
jakul	lat
ejhle	ces
eklipt	lat,ell
eklog	lat,ell
ekz	deu,ell
elabor	deu,lat
elán	fra,lat
elast	lat,ell
eldo	spa,lat
elegán	fra,lat
elegant	lat
eleganc	lat
elegik	lat,ell
eleg	lat,ell
elegie	lat,ell
elektro-	ell
onk	eng
elektř	ell
elév	fra,lat
elev	lat
elf	eng,ang
limin	lat
elips	lat,ell
elit	fra,lat
lix	lat,ara,ell
elokvenc	lat
email	fra,deu
eman	lat
mancipac	lat
embarg	deu,spa,lat
embl	fra,lat,ell
embol	ell
embryo	lat,ell
emerit	lat
emfáz	lat,ell
Eminence	lat
emin	lat
emír	ara
emoc	fra,frm,fro,lat
empír	fra,lat
emu	por
emulz	lat
in-1	ell
en-	ell
encefal	ell
encián	deu,lat
endo-	ell
krin	ell
enormn	deu,lat
ent	lat
entom	ell
entropie	ell
enzym	ell
epentetický	ell
epentez	ell
epi-	ell
ep	ell
leps	lat,ell
epitaf	lat,ell
epitel	lat
epiteton	ell
epizod	fra,ell
epochál	deu,ell
epoch	deu,ell
epolet	fra,lat,ell
epo	ell
pej	ell
epos	ell
éra	lat
erb	gmh
erekc	lat
erg	ell
eror	eng,lat
erot	fra,ell
erotic	fra,ell
eroto	ell
erotomani	ell
eroze	lat
errata	lat
ertepl	deu,fra
rupt	lat
esejist	eng,fro,lat
esenc	lat
sác	deu
sák	deu
eschat	ell
eskadr	fra,spa,lat
eskadron	fra,ita,lat
eskal	eng,fra,lat
eskalát	eng
eska	fra,spa,lat
kort	fra,ita,lat
eskort	fra,ita,lat
as	gmh,fra,lat
es	gmh,fra,lat
oteric	ell
esper	spa,fra
espres	ita,lat
esprit	fra,lat
estak	fra,ita
estét	fra
esté	fra
estro	lat,ell
ešus	deu
etamín	fra,fro,lat
etan	lat,ell
éter	lat,ell
eternit	lat
eter	lat
etik	deu,lat,ell
etický	deu,lat,ell
etika	deu,lat,ell
etiket	fra,fro
eti	lat,ell
etnick	ell
etno-	ell
étos	ell
etud	fra,fro,lat
etuje	fra,fro,lat
etymo	lat,ell
eu-	ell
eufori	ell
eugen	ell
euchar	lat,ell
euka	ell
eunuch	lat,ell
eutanaz	ell
evangelík	lat,ell
evangeli	lat,ell
ual	fra,lat
evok	lat
evoluc	lat
ex	lat
ex-	lat,ell
amin	lat
Excelence	lat
celent	deu,lat
cerpc	lat
cerpč	lat
cerp	lat
exces	deu,lat
gez	lat,ell
kutor	lat
exekuc	lat
exemplář	deu,lat
exerc	lat
halát	lat
exitus	lat
exi	lat
krement	lat
kurs	lat
libris	lat
exo-	ell
exod	lat,ell
exorc	lat,ell
expert	deu,lat
ploat	fra,lat
plozív	lat
exponent	lat
extat	lat,ell
extáz	lat,ell
extrakc	lat
extrakt	lat
vaganc	fra,lat
vag	fra,lat
extrémn	deu,fra,lat
extrem	deu,fra,lat
extrém	deu,fra,lat
exulant	lat
fábor	ces
fab	lat
fac	ces
fack	ces
fač	lat
fáč	lat
fag	ell
fagot	deu,ita
fachč	deu
faján	fra,ita
fajfk	deu,lat
fajr	deu
fakan	ces
fakír	ara
fak	lat
faktor	ces
fakul	lat
fakult	lat
falang	ell
fald	gmh
falš	gmh,fro,lat
falick	ell
fal	deu,ita,lat
fám	lat
famfárum	fra,spa
famili	deu,lat
famíli	lat
fam	deu,lat
fámul	lat
fand	eng
fanfár	deu,fra
fanfarón	fra,spa
fangl	deu
fank	deu,lat
fanouš	eng
fantast	deu
fantom	fra,fro,ell
fanyn	eng
farář	gmh,lat,ell
farad	eng
farao	lat,ell,heb,egy
farmac	lat,ell
farmako-	ell
faryng	ell
fasád	deu,fra,ita,lat
fascikl	deu,lat
faset	fra,lat
fasuněk	deu
fašank	ces
fašír	deu,fra,lat
fat	ita
fatal	deu,lat
fatál	deu,lat
favor	fra,ita,lat
favorit	fra,ita,lat
fax	eng,lat
fazon	fra,lat
federal	lat
fedr	deu
féeri	fra,lat
fekál	deu,fra,lat
felčar	deu
fén	deu
fen	ces
fenik	deu
fénix	lat,ell
fenol	fra,ell
fenomen	deu,lat,ell
fenomén	deu,lat,ell
fenykl	lat
ferbl	deu
ferin	ces
ferment	lat
fero-	lat
fertil	lat
fertilit	lat
fěrt	gmh
fešák	deu,eng,fra
fešand	deu,eng,fra
fešn	deu,eng,fra
feťák	deu
feťáck	deu
fet	deu
feudal	deu,lat,deu
fiakr	fra
fiál	deu,lat,ell
fiasko	ita
fidl	deu
fiflen	ces
fift	eng
fígl	ces
figurín	ita
-fikace	lat
fikt	lat
-fil	ell
filantrop	ell
filck	deu
filé	fra,lat
filek	pol
filigrán	deu,ita
filmař	eng
filodendron	ell
filut	fra
fimóz	ell
financ	deu,fra,fro,lat
fiňáry	fra
fines	fra
finišman	eng,fro,lat
firem	ita,lat
firm	ita,lat
firn	lit,deu
fistul	lat
fiší	fra,lat
fišk	ces
fištrón	deu
nesscentr	eng,fra,lat
fixl	deu
fízl	deu,gmh
fiž	fra,lat
fjord	nor
fládr	gmh
flagrant	lat
flaks	deu
flamendr	deu
fland	gmh
flastr	gmh,lat,ell
flašk	gmh
flaut	ita,lat
flažolet	fra
flíček	deu
fleret	fra,lat
flétn	deu,fro
flíghorna	deu
flik	deu
flink	deu
flint	deu
flísna	deu
flitr	deu
flok	deu
flór1	deu,nld,fra
flór2	lat
flór	lat
floskul	lat
flot	deu,spa,fro,deu
flout	deu,spa,fro,deu
fluid	lat
flukt	lat
flundr	deu
fluorescenc	lat
fluor	lat
fňuk	ces
fobi	ell
foch	deu
fokus	lat
foli	deu,lat
fóli	lat
fol	eng
folklorn	eng
-fon	ell
fontán	deu,lat
forček	eng
forhont	deu
forint	deu,ita
formaldehyd	lat
formalin	lat
forman	gmh
forot	deu
fors	deu,fra,lat
forš	deu
forte	ita,lat
fortel	gmh
forti	lat
fortn	deu,lat
fortun	lat
forvard	eng
forz	eng
ýt	eng
fořt	deu
fosf	fra
fosgen	ell
fosil	lat
fosilie	lat
fošn	deu,lat
fotel	fra,fro,frk
foto-1	ell
buň	ces
syntéz	lat,ell
fotr	deu
fouň	ces
fous	ces
fox	eng
foxtrot	eng
foyer	fra,fro,lat
fracek	deu
fraj	deu
frajír	deu
frajer	deu
frajl	deu
frak	deu,eng,fro
frakč	lat
frakc	lat
frakt	lat
franc	deu
iškán	ita
išk	ita
frapant	fra
fráter	lat
fraze	deu,lat,ell
frc	deu
frč	ces
frčk	ces
fregat	ita
frekvenč	lat
frekvenc	lat
frenet	lat,ell
fresk	ita,deu
fretk	deu,fra,lat
frik	lat
frikc	lat
frivol	fra,lat
frizúr	deu,fra
frk	ces
frňák	ces
frnk	ces
frontis	fra,lat
frot	fra
frukt	lat
frustr	lat
frustrac	lat
fuch	deu
fujar	ron,sqi
fuk2	lat
fukar	deu
fundamentál	lat
fungln	deu
fungl	deu
funkč	lat
funkc	lat
fung	lat
fůr	gmh
furi	lat
fúri	lat
furóre	ita,lat
furt	deu
furunkl	deu,lat
fusek	deu,lat,ell
fušer	deu
fušeř	deu
futrál	deu,lat,gmh
fyto-	ell
fyzik	lat,ell
fyzio	deu,lat,ell
gnom	deu,lat,ell
gabardén	deu,fra,spa
gabr	ita
gag	eng
gajdoš	ces
gajdy	ces
gala	deu,fra,spa
galakt	lat,ell
galax	lat,ell
galér	ita,lat
galer	ita,lat
galim	deu,fra
atyáš	deu,fra
galon	eng,fro
galoš	deu,fra
galvan	ita
gamb	ita,lat
gambi	spa,ita
game	eng
gangster	eng
gang	eng
gangl	lat,ell
gangrén	lat,ell
gangstersk	eng
garant	deu,fra,fro,deu
garanc	deu,fra,fro,deu
garáž	fra,deu
garded	fra
garden party	eng
roba	fra
garnát	deu,nld
garnitur	deu,fra,fro,deu
garson	fra
gatě	ces
gaudi	lat
gauner	deu
gav	fra
gáz	fra,spa,ara,pes
gazd	hun
gazel	fra,spa,ara
gáž	fra,fro,deu
gejš	jpn
gejzír	isl
gel	lat
geminace	lat
genea	ell
general	lat
genez	fra,lat,ell
geni	lat
genial	lat
géni	lat
genocid	lat
geo-	ell
geodet	fra,ell
detic	fra,ell
gepard	deu,fra,ita
geront	ell
gestap	lat
ghett	ita
gibbon	fra
gib	fra
gig	lat,ell
gigant	lat,ell
gigol	fra
gilotina	fra
gin	eng,fra,lat
girland	fra,ita
glaci	lat
glaciál	lat
gladiol	lat
glajch	deu
glanc	deu
glaz	fra,lat
glazur	deu,fra
glejt	gmh
globul	lat
glób	lat
gloriol	lat
gluk	deu,fra,ell
glycerin	fra,ell
glykemie	ell
gnóma	ell
gobelín	fra
gój	heb
golfk	eng
golf1	eng
golf2	deu,ita,lat,ell
gomb	hun
gong	eng,zlm
gonio	ell
goril	ell
gotes	deu
gotic	lat
gotik	lat
gracióz	fra
grác	fra
-graf	ell
graffiti	ita
-grafie	ell
grafik	ell
grafo-	ell
grál	fro
-gram	ell
granát1	gmh,lat
granát2	gmh,lat
grand	spa,lat
grandiózn	ita
granit	ita,lat
granul	lat
grape	eng,lat
fruit	eng,lat
grapefru	eng,lat
gratis	lat
gratul	lat
ulant	lat
gregori	lat
grémium	deu,lat
grenadin	fra
grep	eng,lat
grešl	deu
grif	deu
grimas	deu,fra,deu
griotk	fra,lat
grizzl	eng,enm,fra
gró	fra,lat
gróf	deu
grog	eng
grogg	eng
groš	lat
grunt	deu,deu
grup	deu,fra,ita
gumák	lat,ell,egy
gurmán	fra
guta	eng,zlm
perč	eng,zlm
gutur	lat
guturál	lat
gymnaz	lat,ell
gymnazi	lat,ell
gymnazij	lat,ell
gymnázi	lat,ell
gyps	deu,lat,ell
habaďúr	lat
habán	deu
háb	lat
haciend	spa,lat
hač	lav
háč	deu
háď	ces
háda	ces
hadř	gmh
hadrárna	gmh
hafan	ces
hagio	ell
hajda	tur
láck	tur
hajdalák	tur
hajduk	hun
hajdy	tur,ron,deu
hajl	deu
hajzlík	deu
hajzl	deu
háček	gmh
hákl	deu
haksn	deu
halaba	ces
halam	ces
partn	deu,gmh
halasn	ces
hald	deu
halenk	ces
halen	ces
halit	ukr
halm	ell
haló	ces
halo	ell
halogen	ell
halt	deu
cin	lat,ell
haluc	lat,ell
haluš	pol
haluz	ces
haluzn	gmh,deu
hambal	gmh
burger	eng
hamoun	ces
hampejz	gmh
hamr	deu
handicap	eng
handrk	deu
hangár	fra,lat,ell
hantýr	deu,fra
hap	ces
happen	eng
happ	eng
hapr	deu
hapták	deu
haraburd	ces
harakiri	jpn
harant	deu
hár	ces
hard	eng
harém	tur,ara
harf	ces
harlek	ita
harlekýn	ita
harm	lat,ell
harpyje	ell
hartusivý	ces
hartus	ces
hastr	gmh
hastroš	deu
hať	ces
hattrick	eng
haur	deu
háv	ces
havarij	deu,fra,ita
havar	deu,fra,ita
havár	deu,fra,ita
havelok	eng
havěť	ces
haz	ces
hazuk	deu,gmh
legrac	deu
hegemonic	ell
hej	ces
hejl	ces
hejn	ces
hejsek	ces
hejtman	deu
hekatomb	ell
hektar	fra,ell
hektic	deu,fra,ell
heleď	ces
hele	ces
helikoptér	fra,ell
helium	ell
helvet	lat
hemero	lat,ell
hemi	ell
hemo-	ell
hemo	lat
hemoroidy	lat,ell
hemž	ces
hen	fra,ara
hepat	lat,ell
itid	lat,ell
hepta-	ell
herberk	deu
herdek	hun
heredita	lat
heret	lat,ell
herez	lat,ell
hergot	deu
herk	deu
herkules	ell
hermafrod	ell
hermelín	deu
hermet	ell
herold	gmh,frm,deu
herynek	gmh
heryn	gmh
hetero-	ell
heter	ell
hever	deu
hexenšus	deu
hex	deu
hexa-	ell
hezoun	ces
hic	deu
hiero	fra,ell
glyf	fra,ell
hihň	ces
hiphiphurá	eng
hiphip	eng
hipo	ell
hipík	eng
hipízák	eng
hippie	eng
histork	lat,ell
hit	eng
głos	ces
gólos	ces
glâs	ces
głowa	ces
golová	ces
gláva	ces
nevzhledný	ces
hlíž	ces
ględzieć	ces
gljadéť	ces
glȅdati	ces
hlemýžd	ces
mýžď	ces
hlemýžď	ces
hles	ces
hlezen	pol,chu
hlezn	pol,chu
hlink	ces
hlín	ces
hlísta	ces
hlíst	ces
hlív	ces
hlíznat	ces
hlož	ces
hlomoz	ces
hltan	ces
hltav	ces
hlboký	ces
glęboki	ces
glubókij	ces
hlybókij	ces
globòk	ces
glǫbokъ	ces
hluš	ces
hlouč	ces
hm	ces
hmožd	ces
hňáca	ces
hnát1	ces
hnac	ces
shon	ces
gnać	ces
gnať	ces
gnȁti	ces
hnát2	ces
pich	ces
hnil	ces
hníp	ang,deu
hnís	ces
shni	ces
hnůj	ces
hobby	eng
hoblin	deu
hody	ces
hodn	ces
się	ces
godíťsja	ces
hodit	ces
hodit se	ces
hodl	ces
hodně	ces
hof	deu
hoš	ces
hošan	ces
hošán	ces
hoch	ces
hochštaplersk	deu
hochštapler	deu
↑hej	ces
hojn	ces
hokynář	gmh
hola	ces
holb	deu
holeček	ces
holen	ces
holocaust	eng,fro,lat,ell
cén	ell
holom	ces
holt	deu,gmh
holubin	ces
holic	ces
holič	ces
homeo	ell
homeop	ell
homi	lat,ell
homili	lat,ell
homo-	ell
homunkul	lat
honic	ces
honec	ces
honb	ces
honitb	ces
Všesl.	ces
honos	ces
hopsa	ces
hůrk	pol
horní	pol
hord	tat
horent	deu,lat
horko	ces
horn	deu
horo	lat,ell
hortenz	fra
hořec	ces
gorzeć	ces
goreć	ces
goréť	ces
gòreti	ces
gòrjeti	ces
hořk	ces
hosana	lat,ell,heb
hospic	deu,lat
hospůd	ces
Hospodin	ces
hostinský	ces
hostesk	eng,fro,lat
hotdog	eng
hotýl	deu,fra,fro,lat
hoteliér	deu,fra,fro,lat
hotentot	ces
hotovo	ces
hotovk	ces
houn	ces
houser	ces
housti	ces
houžv	ces
hovád	ces
hovad	ces
hověz	ces
hovězí	ces
hovín	ces
hovn	ces
hovoř	ces
hern	ces
hříčk	ces
hřišt	ces
hrabl	ces
hrabě	goh
hradl	ces
hraz	ces
gród	ces
górod	ces
grâd	ces
hráš	ces
hrách	ces
hranat	ces
hranol	ces
hrana1	ces
hrana2	ces
hráz	ces
hrbol	ces
hrč	ces
hrdin	ces
hrdličk	pol,chu
hrdel	ces
hrkot	ces
hrm	ces
hrnek	ces
hrneč	ces
hrnec	ces
garnąć	ces
gornúť	ces
hrobař	ces
hroch	ces
hroud	ces
hrout	ces
hrozen	ces
hrstk	ces
hrst	ces
hruď	ces
hrůzn	ces
hrůž	ces
hrůz	ces
hřej	ces
hřev	ces
grzać	ces
greť	ces
grȅjati	ces
̏jati	ces
grějati	ces
hřebč	ces
hřebelec	ces
hřebín	ces
hřeben	ces
hříšn	ces
hříšnic	ces
hřích	ces
hřív	ces
hřivn	ces
hřmě	ces
hřmot	ces
hřm	ces
hukot	ces
hudr	ces
huhl	ces
hůl	ces
hulák	ces
hist	pol
hulán	pol
human	lat
humbuk	eng
humid	lat
humn	ces
humř	deu,isl
huňáč	ces
huň	ces
hunt	deu
hurra	ces
hurá	ces
hurikán	eng,spa
hurisk	pes,ara
hurtem	gmh,fro
house	ces
husák	ces
huspen	ces
hutnick	gmh
ctv	gmh
huť	gmh
hvizd	ces
hyac	lat,ell
hydrant	eng,ell
hydro-	ell
hydro	ell
hygroskop	ell
hyje	deu,fra
hýl	ces
hymen	ell
nehynoucí	ces
hyper-	ell
trofi	ell
hypo-	ell
chondric	ell
hypokoristikon	ell
hytl	deu
hýžď	ces
hýžd	ces
chabrus	deu,heb
chalcedon	lat,ell
chaluh	ces
chaloup	ces
chám	ces
chám2	ces
chamraď	ces
chamtiv	ces
chán	tur
chaot	ell
chaos	ell
chap	ces
chargé d’ affaires	fra
charismat	ell
charism	ell
chart	lat,ell
chásk	ces
chatk	ces
chatrč	ces
-cházet	ces
chcan	pol,chu
checht	lat,ell
chemikál	deu,lat,ell
cherubín	lat,ell,heb
chich	ces
chili	lat,ell
chin	deu,ita,spa
chiro	ell
chiruržk	lat,ell
chit	fra,ell
chlaz	ces
chláp	ces
chlebíč	ces
chléb	ces
chlemt	ces
chlív	ces
chlévsk	ces
chlév	ces
chlípn	ces
chlopň	ces
chlo	ces
chlorid	ell
chloro	lat,ell
chlorofyl	fra,ell
chlub	ces
chlum	ces
chloup	ces
chlupatět	ces
chmelnic	ces
chňapk	deu
chaz	ces
chůz	ces
chodzić	ces
chodíť	ces
hòditi	ces
choditi	ces
choleric	ell
cholesterol	ell
chomout	ces
choroš	pol
choť	ces
chovn	ces
chův	ces
chramst	ces
chránicí	ces
chraň	ces
chrapot	ces
chrap	ces
chrapt	ces
chráp	ces
chrás	ces
chrastav	ces
chrestomat	lat,ell
chrchel	ces
chrob	ces
chrochtav	ces
chrocht	ces
chromák	ces
chromajzl	ces
chropt	ces
chrop	ces
chrous	ces
chroust	ces
chryzantém	lat,ell
chřad	ces
chřást	ces
chříp	ces
chřtán	ces
chuď	ces
chuděra	ces
chudý	ces
chůd	ces
chuj	pol
chum	ces
chumelen	ces
chuml	ces
nechutný	ces
teb	ces
chvást	ces
-chvátit	ces
chvě	ces
chvíl	ces
chvojk	ces
chvoj	ces
chvost	ces
chýš	ces
chyták	ces
jinde)	ces
i	ces
ibis	ell
ibišek	lat,ell
identic	lat
ident	lat
idio-	ell
idiom	ell
idol	lat,ell
igel	deu
igl	eng
ignoranc	lat
ignor	lat
ichty	ell
ikeban	jpn
noklasm	ell
nostas	ell
ilegal	lat
image	eng,fra,lat
imám	ara
imbecil	lat
imbecilit	lat
imbec	lat
imortel	fra,lat
impéri	lat
impertinenc	deu,lat
impertinent	deu,lat
implik	lat
potent	lat
presár	ita,lat
impuls	deu,lat
in-1	lat
in-	lat
un-	lat
in-2	lat
in flagranti	lat
incest	lat
incident	deu,lat
index	lat
indic	lat
indikátor	lat
indis	lat
krec	lat
indukč	lat
indukc	lat
industrial	fra,lat
infant	spa,lat
infanter	deu,ita
infantil	deu,lat
infikovat	lat
flač	lat
fl	lat
infra-	lat
infúz	lat
ingot	eng
ingredienc	lat
inhalac	lat
inhalač	lat
inhalát	lat
iniciál	lat
iniciátor	fra,lat
inklin	lat
inkognito	ita,lat
inkvizice	lat
inovač	lat
inov	lat
signi	lat
spekč	lat
spicient	deu,lat
instrukt	rus
instrukc	rus
intarz	ita,ara
integrit	lat
intenc	lat
intendanc	deu,fra,lat
intend	deu,fra,lat
intenz	lat
inter-1	lat
inter-2	fra
interesant	fra,lat
interiér	fra,lat
inter	lat
interní	lat
interpret	lat
punkč	lat
interview	eng,fra,lat
intrád	deu,ita,lat
intro-	lat
intuit	lat
intuic	lat
vestor	lat
inzerc	deu
inzert	deu
inzult	lat
irid	lat,ell
ischias	lat,ell
islám	ara
itiner	lat
izo-	ell
izolac	fra,ita,lat
já	ces
jableč	ces
jadér	ces
jader	ces
jadr	ces
jádř	ces
jaguár	por
jahelník	ces
jahůd	ces
jak1	ces
jakmile	ces
bín	fra
jambic	lat,ell
jamb	lat,ell
janek	ell
janov	gmh,lat
jantar	rus,lit
jarmareč	deu
jarmark	deu
jař	ces
jařin	ces
jářku	ces
jásot	ces
jasnost	ces
jat	ces
jatk	ces
jeb	ces
jekot	ces
čmen	ces
ječmen	ces
jeden	ces
jedle	ces
jégr	deu
ičn	ces
jehlan	ces
jehň	ces
jehněčí	ces
jehn	ces
jehněd	ces
jeho	ces
její	ces
jelín	ces
jelikož	ces
jelítk	ces
-jem	ces
jémine	lat
jenom	ces
jeptiš	lat
jept	lat
jer	ces
řabin	ces
jeřáb1	ces
jeřáb2	ces
jeřábek	ces
jeseň	slk,pol,chu
jeset	ces
jeseter	ces
jeskyňk	ces
jeskyň	ces
jestliže	ces
jestli	ces
ješita	ces
ješt	ces
ještěř	ces
ještěrk	ces
jechać	ces
jéchať	ces
jȁhati	ces
jachati	ces
jet	ces
jetelin	ces
jezdec	ces
jížď	ces
soudí	ces
jezír	ces
jezink	ces
jezuit	lat
jezul	lat
ježd	ces
ježibab	ces
ježíš	lat,ell,heb
ježto	ces
jh	ces
jícn	ces
jícen	ces
jidáš	heb
jidiš	deu,heb
jižan	ces
jil	gmh
jín	ces
jinoš	ces
jino	ces
jinud	ces
jír	ces
jiř	ces
jiřink	deu
jiřin	deu
jiskřičk	ces
jídl	ces
nís	ces
jeść	ces
jesť	ces
jȅsti	ces
jasti	ces
jišt	ces
jišť	ces
jitro1	ces
jitro2	ces
jíz	ces
jízl	ces
jmel	ces
jmě	ces
jmenovatel	ces
jmén	ces
pojetí	ces
jieti	ces
jmu	ces
jo	deu
jodid	fra,ell
jódl	deu
jog	ces
jogín	ces
jol	deu,gml
jonák	deu
jot	ell,heb
joule	eng
jsi	ces
js	ces
jesmь	ces
jèsam	ces
jsem	ces
jubil	lat
jubilant	lat
jubileum	lat
jucht	deu,rus
jun	srp,hrv
ju	srp,hrv
junák	srp,hrv
jund	ces
junior	lat
junkersk	deu,gmh
junker	deu,gmh
junt	spa,lat
jura2	ces
jurisdikc	lat
jurt	rus,tat
jur	fra,eng,fro,lat
just	deu,eng,fra,lat
justič	lat
justic	lat
juxtapoz	lat
ke	ces
kaba	heb
kab	ron
kabink	deu,fra,eng,frm,lat
kabriolet	fra,ita,lat
kačk	ces
káč	ces
kačer	ces
kač	ces
kád	ces
káď	ces
kadi	ces
kadlub	ces
kadmium	ell
kafíčk	deu,fra,hye,tur,ara
kaf	deu,fra,hye,tur,ara
kafiler	deu
kaftan	tur,ara,pes
kahan	ces
kachel	deu,lat,ell
kach	ces
kajman	spa
kakadu	deu,nld,zlm
kaln	ces
kalič	ces
kalafun	ita,ell
kalamajk	slk,ukr
kalamář	lat
kalambúr	fra
kalamit	lat
kalc	lat,ell
kalibr	deu,fra
kalif	ara
kalíš	gmh,lat
kalin	ces
kalkovat	fra,lat
kaloň	eng
kalounek	fra
kaloun	fra
kalous	ces
kalumet	fra,lat
kalup	deu,ita,fro,frk
kalužka	ces
kalužin	ces
kaluž	ces
kalvár	lat
kamkoli	ces
kamaril	spa
kamaš	deu,fra,spa,ara
kamba	rus,fin
kamej	fra,fro
kamelot	fra
kamenick	ces
kámen	ces
kamikadz	jpn
kampaň	fra,lat
kampan	ita,lat
kampel	ces
kamrlík	deu,lat
kamu	fra,ita
fláž	fra,ita
kamufl	fra,ita
kana	deu,fra,fro,lat
kanal	lat,ell
kanapíč	deu,fra,lat,ell
kanap	deu,fra,lat,ell
kanast	spa,lat,ell
kanav	fra
kancer	lat
kanc	lat
kancl	deu,lat
kandelábr	deu,fra,lat
kand	ita,ara
káně	ces
kanč	ces
kanec	ces
kanička	ces
kankán	fra
kanonád	deu,fra,ita,lat
kanonýr	deu,fra,ita,lat
kaňon	spa,lat
kanonic	lat,ell
kánon	lat,ell
kantilén	ita,lat
kanton	fra,ita
kantor	lat
kantýnský	deu,fra,ita
kanystr	eng
kapacit	lat
kapac	lat
kapar	lat,ell
kapán	ces
kvapkať	ces
kapać	ces
kápať	ces
kȁpati	ces
kapati	ces
kapiový	bul,tur
kapi	bul,tur
kapitol	lat
kaplan	gmh,lat
kapot	fra,lat
kapřík	ces
kapř	ces
kapr	ces
kaprad	ces
kapraď	ces
kaprál	fra,ita,lat
kapric	deu,fra,ita
kapsář	lat
kapslík	deu,lat
kapuc	deu,ita,lat
kaput	deu,fra
karabáč	ces
karabink	fra
karaf	ita,ara
karas	ces
karát	deu,fra,ita,ara,ell
kárn	ces
karate	jpn
karav	ita,pes
karavel	ita,spa,lat,ell
karb	ces
karbanick	ces
karbid	lat
karbon	lat
karborund	lat
karbur	fra,lat
karcer	lat
karcinom	lat,ell
kardiak	lat,ell
kardin	lat
kardio-	ell
karg	spa,lat
kari	eng
kariéra	fra,ita,lat
karneval	ita,lat
karoser	fra,ita
karet	ita,lat
kartezián	fra
kartezi	fra
téč	deu
kartuzián	fra
kartuz	fra
karyatid	ell
kasár	deu,fra,lat
kasárnický	deu,fra,lat
kasárn	deu,fra,lat
kasematy	deu,fra,ita
kasin	ita,lat
kaskadér	fra
kaskad	fra
kasta	spa
kastrát	lat
kastrolek/kastrůlek	fra,lat
kastrolový	fra,lat
kastrol	fra,lat
kašel	ces
kašpar	deu
kašpárk	deu
kašpařin	deu
kašpár	deu
kaštán	lat,ell
katyně	ces
kata-	ell
katafalk	deu,fra,ita,lat
lyzátor	eng,ell
katamaran	eng
katar	lat,ell
strál	deu,ita,ell
katastr	deu,ita,ell
strofic	ell
kaťat	ces
katedrál	lat
katechet	lat,ell
katechez	lat,ell
katech	lat,ell
katétr	ell
katolík	lat,ell
katolic	lat,ell
katr	deu
kauč	lat
kauc	lat
19.st.	fra,spa
kauzalit	lat
kauz	lat
kavárn	tur,ara
kavár	tur,ara
kavaler	fra,ita,lat
kavč	ces
kavk	ces
kazać	ces
kazet	ita
kazivý	ces
kaž	ces
kdo	ces
kdoul	ces
když	ces
kebul	ces
kecky	ces
čup	eng,zho
kečup	eng,zho
dlubn	deu
kedlub	deu
kejh	ces
kejklíř	deu
kejkl	deu
kejkle	deu
keks	eng
kelím	pol
kentaur	ell
keprov	deu,nld
kepr	deu,nld
keramic	fra,ell
keřík	ces
keříč	ces
keser	eng
keson	fra,lat
keš	eng,fra,por
keťas	deu,lat
kéž	ces
khaki	eng,pes
kilo-	ell
kin	fra,ell
kinžál	rus,tat
kisn	deu,lat
kivi1	ces
klacík	deu
klacíč	deu
klac	deu
klacek	deu
kladiv	ces
klak	fra
klakson	eng
klandr	deu
klán	ces
klapot	ces
klapk	deu
klaret	fro,lat
klásek	ces
kłaść	ces
klasť	ces
klȁsti	ces
klasti	ces
klás	ces
kláti	ces
klauzul	lat
klavi	lat
klav	lat
klíck	ces
klem	ell
atis	ell
klemp	deu,ita,lat
klencák	deu
klenot	gmh
kle	ces
klenut	ces
klept	ell
kleptomanský	ell
kleptomanie	ell
klér	lat,ell
klíšťk	ces
klíček	ces
klíz	ces
klizeň	ces
klientel	deu,lat
klient	deu,lat
kliž	ces
klič	ces
klika1	ces
klika2	fra
klika3	deu
klimat	deu,lat,ell
klimakter	ell
klimakteri	ell
klím	ces
klimpr	deu
klinč	eng
klinic	deu,fra,ell
klink	ces
klip	eng
klipsn	eng
klips	eng
klišé	fra
klíšť	ces
klíšt	ces
klí	ces
klitoris	ell
klk	ces
kloak	lat
klohn	ces
klok	ces
klopot	ces
kloud	ces
kluzák	ces
klozet	eng,fro,lat
kloz	eng,fro,lat
klůcek	deu
klouč	ces
klukovin	ces
kmán	deu
kmín	ces
kmet	ces
knajp	deu
knajpovat	deu
knap	deu
knedl	gmh
lík	gmh
kněz	ces
ovnic	ces
kník	ces
knírk	ces
kníže	ces
knofl	gmh
knoflík	gmh
knut	rus,isl
kodrcat	lit,lav
komíhat	lit,lav
ga-	lit,lav
ko-1	lit,lav
ko-2	lat
koalič	lat
koal	lat
koalic	lat
kobereč	lat
koberc	lat
koberec	lat
kobk	gmh
kobr	por,lat
ouř	ces
kočí	hun
kočko	pol
kodein	fra,ell
kodex	lat
kační	lat
koeficient	lat
koflík	gmh,lat
kognit	eng,lat
kohoutek	ces
kohoutový	ces
koch	ces
koit	lat
kój	deu,nld,dum,lat
kojot	eng,spa
koka	spa
kokard	deu,fra
koketer	fra
kokil	fra,lat,ell
kokon	fra,lat,ell
kokoř	ces
kokosov	deu,por,fra,lat
kokot	ces
kokp	eng
kokrhavý	ces
kokršpaněl	eng,fro,lat
koksárn	deu,eng
koksár	deu,eng
koktejl	eng
kolaps	lat
kolár	lat
koláž	fra,lat,ell
kolej2	lat
kolekc	lat
-koli	ces
kolib	ell
kolize	lat
koliz	lat
koli	eng
kolikrát	ces
koljuš	rus
koln	ces
hná	ces
kolokvi	lat
kolomaz	ces
kolonád	fra,ita
kolosál	lat,ell
kolos	lat,ell
kolouš	ces
kolt	ces
com-	lat
kom-	lat
atóz	ell
kóm	ell
komář	ces
komár	ces
kombaj	rus,eng,lat
kombi	deu
kombinátový	rus,lat
kombinatorní	lat
komedie	lat,ell
komerč	fra,lat
komerc	fra,lat
komič	lat,ell
komic	lat,ell
kominík	ces
kominíč	ces
kominick	ces
komin	ces
komision	lat
komisariát	lat
komité	fra,eng,lat
komnat	lat
komod	fra
komodit	eng,lat
komoň	ces
komůr	lat
komorn	lat
komoří	lat
pars	deu,fra,ita,lat
kompas	ita,lat
pendi	lat
penzač	lat
komplic	deu,fra,lat
komplik	lat
kompliment	deu,fra,spa,lat
komplot	deu,fra,fro
kompost	deu,fra,eng,fro,lat
promis	lat
komt	fra,lat
munik	lat
komž	lat
koňadr	ces
cern	eng,fra,fro,lat
koncern	eng,fra,fro,lat
cert	deu,ita,lat
konces	lat
konciz	lat
denzač	lat
kondenz	lat
kondič	lat
kondic	lat
kondolenc	lat
kondolenč	lat
kondor	spa
koncový	ces
ova	ces
konec	ces
konýv	pol
konvičk	pol
konev	pol
konex	lat
konfety	ita,lat
fident	lat
konfisk	lat
konfuz	lat
konglomerát	lat
gruenc	lat
kónick	fra,lat,ell
koníček	ces
konikl	ces
konjunktivní	lat
konjunktiv	lat
junktur	deu,lat
junkt	deu,lat
konkordát	lat
konkrét	lat
kubín	lat
otač	eng,lat
konsekvence	lat
sens	lat
konsensus	lat
konsens	lat
konsonantismus	lat
sorc	lat
stru	lat
tamin	lat
kontejner	eng,fro,lat
konting	deu,fra,lat
tinu	lat
kontinuace	lat
kontr	lat
kontrakc	lat
kontrolor	deu,fra,frm,lat
kontur	deu,fra,ita,lat
vergent	lat
vergenc	lat
vex	lat
konvic	pol
konvoj	fra,fro,lat
ativ	deu,eng,lat
konzilium	lat
konzistoř	lat
konzulát	lat
zum	lat
kooptac	lat
kopa1	ces
kopa2	gmh,lat
kopáč	ces
nec	ces
kopanic	ces
kopać	ces
kopáť	ces
kòpati	ces
kopati	ces
kopc	ces
kopejk	rus
kopiník	ces
kopi	lat
kopist	ces
koprovk	ces
koprn	ces
kopýtk	ces
koráb	ces
korán	ara
korb	lat
korbíl	deu,lat
korbel	deu,lat
kord	ces
kordon	fra,lat,ell
korec	ces
kork	deu,ara,spa,lat
korek	deu,ara,spa,lat
korekt	lat
korelač	lat
korel	lat
respond	lat
koriandr	lat,ell
korid	spa,lat
koridor	deu,ita,lat
kormidel	rus
kormidl	rus
kormorán	fra,lat,fro,deu
kornet1	fra,lat
kornet2	ita,lat
koron	lat,ell
koroptv	ces
koroptev	ces
korouhv	ces
rouhev	ces
rump	lat
korund	deu,eng
ryf	lat,ell
korýš	lat
korýtk	ces
koryt	ces
kořala	pol
kořín	ces
kořenatý	ces
kořisť	ces
kosic	ces
kosák	ces
kosat	ces
kosinus	lat
kosman	ces
kosmetik	fra,ell
kosmo-	ell
kosmos	ell
koso	pol
kůst	ces
kostěn	ces
kostic	ces
kostelník	slk,pol
kostelnic	slk,pol
kostkovat	ces
koster	ces
kostrov	ces
kostroun	ces
kostr	ces
kostrbat	ces
kostýmář	deu,fra,ita,lat
koso-	ces
košatin	ces
košer	heb
košťát	ces
koštýř	deu
koť	ces
kotec	rus
kotlík	ces
kotlář	ces
kotlárn	ces
kotlin	ces
kotel	ces
-kotit	ces
kotn	ces
kotník	ces
kotou	ces
kotoul	ces
kotrb	ces
kotrč	ces
kotev	ces
kukadla	deu
kukátk	deu
kukuč	deu
koukol	ces
kule	gmh
kulk	gmh
kulový	gmh
kulovnice	gmh
kulat	gmh
atin	gmh
kuleč	gmh
kulit	gmh
kúle	gmh
gul’a	gmh
tv.)	gmh
skus	ces
kąsać	ces
kusáť	ces
kúsati	ces
zákou	ces
kout1	ces
kout2	ces
ková	ces
kovár	ces
kujn	ces
kozlík	ces
kozák1	ces
kozác	ukr,rus,tat
kozák2	ukr,rus,tat
kožíš	ces
kožeš	ces
kožich	ces
krabat	ces
kráč	ces
krah	ces
krach	deu
krákor	ces
krákat1	ces
krakorec	deu
kraksn	deu
kralev	ces
kral	ces
králič	ces
kraml	deu
kráp	ces
krap	ces
krasl	ces
krad	ces
ukrást	ces
kraść	ces
krasť	ces
krȁsti	ces
krasti	ces
kroć	ces
krât	ces
kratъ	ces
-krát	ces
kráter	lat,ell
kravín	ces
kráv	ces
kravál	deu
kravat	deu,fra
krcál	ces
skrček	ces
krčm	ces
kreac	lat
kreatur	lat
kredenc	deu,ita,lat
kréd	deu,ita,lat
krejcar	deu
krejčí	ces
krejzlík	deu
krejzl	deu
kremator	lat
krem	lat
kremp	deu
kremrol	deu
kreol	spa,por,lat
krepdešín	fra
krepsilon	fra,fro,lat
kreten	fra,fro,lat
krevel	lat
krhav	ces
krchov	gmh
kriminál	deu,lat
krino	fra,ita
kriplovský	deu
kripl	deu
krček	ces
krkav	ces
krkovič	ces
krkavč	ces
krkavec	ces
krmen	ces
krmě	ces
krmn	ces
krmi	ces
krmiv	ces
krmel	ces
krobi	deu,lat
krocan	ces
kročej	ces
-krojit	ces
krokev	ces
krosn	ces
krotk	ces
krouc	ces
kruc	ces
kręcić	ces
krutíť	ces
krovky	ces
krpál	ces
krtin	ces
krtek	ces
kruci	lat
kruč	ces
krucht	gmh,lat
krumpáč	deu
krunýř	ces
krůp	ces
krust	deu,lat
krypt	lat,ell
krytk	ces
krýš	ces
krýv	ces
kryć	ces
kryť	ces
kryti	ces
křaplav	ces
křečk	ces
křemín	ces
křemen	ces
křem	ces
křepč	ces
křep	ces
elk	ces
křepk	ces
křesíl	pol,rus
křesl	pol,rus
křikl	ces
kři	ces
kloun	ces
krzyczać	ces
kričáť	ces
kríčati	ces
kričati	ces
křidél	ces
křídel	ces
kříšť	ces
křivul	ces
křižác	ces
křižák	ces
křižmo	lat,ell
křoup	ces
křtin	ces
křtěn	ces
křupky	ces
ksicht	deu
ksindl	deu
kšaft	gmh
kšeftík	deu
kšefts	deu
kšír	deu
kštic	ces
kter	ces
kuba1	ell
kubat	deu,lat
kuběn	lat
kuc	ces
kuč	srp,hrv
kučeravět	ces
-kud	ces
kudlan	fra,lat
kudrn	ces
kudy	ces
kufr	deu,fra,lat,ell
kukuřič	ces
kukuřic	ces
kolík	ces
kulack	rus
kulak	rus
kulant	fra,lat
kulíšek	ces
kulich	ces
kulin	deu,lat
kulisák	fra
kulm	lat
kultov	lat
kultiv	lat
kumbál	deu,lat
kumpán	gmh,lat
kumštýř	deu
kumš	deu
koň	ces
konin	ces
kůň	ces
kunčoft	deu
kund	ces
kuň	ces
kupé	fra,lat,ell
kuple	fra,lat
kuplíř	deu,fro,lat
kupol	ita,lat
ku	fra
kupon	fra
kupić	ces
kupować	ces
kupíť	ces
pokupáť	ces
kúpiti	ces
kupòvati	ces
kupiti	ces
kupovati	ces
kurník	ces
kůrk	ces
kurfiřt	deu
kuri	lat
kurikul	lat
kurioz	deu,lat
kuriózn	deu,lat
kurta	deu
izá	fra,ita
kurzivní	lat
kuřát	ces
kuřecí	ces
-kusit	ces
kust	lat
kušn	deu
kutál	gmh
kutl	deu
kutn	deu,lat,deu
kutr	deu,eng
kvač	ces
kvadrant	lat
kvadr	lat
kvadrat	lat
kvadrá	lat
kvák	ces
kvartál	lat
kvartet	ita,lat
kvásek	ces
kvasink	ces
kvaš	fra,ita,lat
kvazar	eng,lat
kvazi-	lat
kvelb	deu
kvér	deu
kverulant	deu,lat
kvítek	ces
kvítk	ces
květen	ces
kvísti	ces
kvest	lat
kvestor	lat
kvikot	ces
kvič	ces
kvintes	lat
kvintet	ita,lat
kvocient	lat
kvoč	lat
kvót	lat
ký	ces
kyan	ell
kyblík	deu
kybl	deu
kýbl	deu
kynout1	ces
kynout2	ces
kypřivý	fra,lat
kypr	fra,lat
kyrysar	deu,fro,lat
kysna	deu,lat
kýt	ces
kytk	ces
kytic	ces
kytlic	deu
kiwać	ces
kiváť	ces
kyz	deu
labi	lat
labut	ces
labuť	ces
labyrint	lat,ell
lác	ces
laclový	deu,fro,lat
lacl	deu,fro,lat
láčk	goh
lač	ces
lačn	ces
sladit	ces
lado	ces
lád	deu
lady	eng,enm,ang
lafet	deu,fra,lat
lágr	deu
lagun	ita,lat
lahev	goh
lahůd	ces
lachtan	rus
laic	lat,ell
laik	lat,ell
lajst	deu
lajs	deu
lajsn	deu
lajtnant	deu,fra
lakýrky	deu,ita,ara,pes
lakmus	deu,dum
lakm	deu,dum
lakomec	ces
lakonic	lat,ell
lakt	lat
lalůč	ces
laloč	ces
lalok	ces
lama	spa
lampas	ell
lampion	deu,fra,ita
lancet	fra,lat
langoš	hun
lang	deu,fra,lat
ust	deu,fra,lat
lanýž	ces
lapál	deu,lat
lapid	lat
lapsus	lat
larg	ita,lat
láryfár	deu
laryngál	lat,ell
laryngální	lat,ell
lasic	ces
lȁsica	ces
lásk	ces
lask	ces
last	srp,hrv
laťk	gmh
lá	ces
lat	ces
latern	lat,ell
láteřivý	gmh
láteř	gmh
latifundistický	lat
latrín	deu,lat
lauf	deu
lávk	ces
lavič	ces
lavor	deu,fra,lat
lazaret	deu,ita
lázeňský	ces
lázeň	ces
leasing	eng,fro,lat
lebečnatý	ces
lec-	ces
leč1	ces
leč2	ces
léčk	ces
leč	hun
ledoborec	ces
ledvink	ces
ledvin	ces
legal	lat
legál	lat
legát	lat
legato	ita,lat
legie	lat
legisl	lat
legislat	lat
legrácky	lat
legrač	lat
leguán	deu,spa
l’ahký	ces
lekki	ces
lëgkij	ces
lȁk	ces
lьgъkъ	ces
lech	rus,srp
lei	ron,lat
leit	deu
lejn	ces
lejstr	lat
̏jek	ces
lěkъ	ces
lekat1	ces
lekat2	ces
leknín	ces
ořic	gmh,lat
lékoř	gmh,lat
lektor	lat
lektvar	lat
lelek	ces
lempl	deu,lat
lemur	lat
lén	gmh
lenoch1	ces
lenoš	deu
lenoch2	deu
lent	ita,lat
leo	lat
pard	lat
lepić	ces
lepíť	ces
lijépiti	ces
lépiti	ces
lěpiti	ces
lepr	lat,ell
lesák	ces
lest	ces
leštič	ces
letarg	lat,ell
letoun	ces
letuš	ces
příle	ces
lecieć	ces
letéť	ces
lètjeti	ces
letěti	ces
letor	lat
letoš	ces
émi	ell
leukoplast	deu,ell
lv	ces
lvic	ces
levhart	gmh,lat
-levit	ces
-lezec	ces
-lezecký	ces
-lezectví	ces
lživ	ces
ležér	deu,fra,lat
ležák	ces
nina	ces
leżeć	ces
ležáť	ces
lèžati	ces
ležati	ces
lhůt	ces
-li	ces
lián	fra
libel	lat
liberál	lat
libid	deu,lat
libret	ita,lat
líčk	ces
licenč	lat
licence	lat
licous	deu
líčit2	ces
ludzie	ces
ljud	ces
ljúdi	ces
ljûdi	ces
ljudije	ces
lídr	eng
lifr	deu,fra,lat
liga	deu
ligatur	lat
lign	lat
liják	ces
likv	ita,lat
lil	deu,fra,ara,pes
lilek	gmh,lat
lili	lat,ell,egy
lilie	lat,ell,egy
limuzín	fra
line	gmh,lat
lini	gmh,lat
ole	lat
linoleum	lat
lenost	ces
lenoch	ces
lipan	ces
lipidy	ell
lir	ita,lat
lís	ces
líska1	ces
líska2	pol
lijav	ces
sliv	ces
lać	ces
liť	ces
lijati	ces
litan	lat,ell
lito	ell
livrej	deu,fra
liz	ces
loaj	fra,lat
loajál	fra,lat
lodyž	pol,rus
lodži	ita,deu
-log	ell
-logie	ell
lógr	deu
loch	gmh
locht	ces
lokál1	deu,fra
lokálový	deu,lat
lokál2	deu,lat
lokál	deu,fra,lat
lokn	deu
loktuš	deu
úlom	ces
loň	ces
lon	ces
loop	eng
lopuch	ces
lopъ	eng
lord	eng
lori1	fra,nld
lori2	eng,zlm
lorňon	fra,frk
los1	ces
los2	deu
loterij	deu
loteri	deu
lotyn	deu,ita,fro,frk
lot	deu,ita,fro,frk
lotř	lat
loub	gmh
luz	ces
úlov	ces
výl	ces
lůž	ces
lóža	ces
lóž	ces
-ložit	ces
lp	ces
lub	ces
luci	lat
lues	lat
luft	deu
luž	ces
loj	ces
lůj	ces
lukový	ces
lul	ces
lumen	lat
lumík	deu
luminiscenč	lat
luminiscenc	lat
luň	ces
lunet	fra,lat
lůn	ces
lunt	deu
lupín	ces
lupin	deu,lat
lux1	lat
lux2	lat
luxus	deu,lat
lůz	deu
luzn	ces
lyc	lat,ell
lysin	ces
lysk	ces
lysec	ces
lys	ces
lyzol	lat,ell
lze	ces
lž	ces
macarát	slv
macat	ces
macech	ces
macek1	ces
macek2	ces
macerát	lat
mac	heb
maceš	ita
mačkavý	ces
máčk	ces
mačky	slk
madam	fra,lat
madl	ces
madonk	ita
madon	ita
madrig	ita
maestr	ita,lat
mafi	ita
mág	lat,ell,peo
magazín	deu,ita,ara
magister	lat
magm	deu,lat,ell
magnát	deu,lat
magn	deu,lat
magnezi	lat,ell
Magnificence	lat
magnol	lat
magořin	ces
magor	ces
maha	deu,eng
mahá	eng
machin	lat
machn	ces
machor	nld
machr	deu
májk	lat
maják	rus
majáles	lat
majestát	lat
majestá	lat
majlant	ita,deu
majolik	ita
majonéz	fra
majon	fra
majordom	lat
majuskul	lat
majzlík	deu
majz	deu
makovič	ces
mák	ces
maka	eng
makak	por
makarony	ita
omak	ces
maket	fra,ita,lat
make-up	eng
makrel	deu,dum
makro-	ell
biot	ell
makul	deu,lat
malachit	ell
malach	ell
malaric	ita
malár	ita
mál	ces
malér	fra
malig	lat
malb	deu
maltéz	ita
málo	ces
malík	ces
mameluk	fra,ara
mamlas	ces
mamo	lat
mamzel	fra,lat
mansk	gmh
maňásk	ces
maňás	ces
manaž	eng,ita
manažer	eng,ita
mančaft	deu
mandant	deu,fra,lat
mandarin	deu,spa
mandarink	deu,spa
mandát	lat
mandolín	deu,fra,ita,lat,ell
mandragor	lat,ell
mandr	eng
manévr	deu,fra,lat
manganistý	deu,ita
mang	deu,por
máni	lat,ell
festac	deu,lat
festač	deu,lat
festant	deu,lat
maník	deu
maniok	fra,spa
pulant	fra,frm,lat
mansard	fra
manšaft	deu
manšestr	eng
mantinel	ita
mantis	lat
manuál	lat
marab	fra,ara
marakuja	por
marasm	ell
marast	deu,gml,dum,frm,fro,deu
maratonec	ell
marihuan	eng,spa
marihua	eng,spa
maringot	fra
marionet	deu,fra
markant	deu,fra,deu
markrabě	gmh
markytán	deu,ita,lat
marn	ces
marš	deu,fra,deu
maršálsk	deu,gmh
maršál	deu,gmh
martyri	lat,ell
marž	fra,lat
masák	ces
masiv	deu,fra,lat
maskér	deu,fra
maskot	fra
maskul	lat
masmédia	eng
masař	ces
mastn	ces
měť	ces
dont	fra,ell
mašinérie	deu,fra,lat,ell
mašin	deu,fra,lat,ell
mašk	ita
arád	ita
mašt	gmh
matador	spa,lat
maté	spa
materiál	deu,lat
matic	deu
máti	ces
mateř	ces
mátožn	ces
matri	lat,ell
mauzoleum	lat,ell
maxi-	lat
máz	gmh
mazl	ces
mazan	ces
mazać	ces
mázať	ces
mȁzati	ces
mazati	ces
mázdr	ces
mazurk	pol
meandr	fra,lat,ell
mečík	ces
mečíř	ces
medov	ces
medovin	ces
měď	ces
medik	lat
medick	lat
medic	lat
médi	deu,lat
mnedle	ces
medle	ces
meduňk	ces
medúz	ita,fra
medvíd	ces
mega-	ell
megalomansk	lat,ell
megaloman	lat,ell
megalomani	lat,ell
meger	lat,ell
ýř	ces
uř	ces
měš	ces
mejdan	srp,hrv,pes
mektav	ces
mekt	ces
mel	ces
melancholick	lat,ell
melancholik	lat,ell
melanchol	lat,ell
melas	fra,lat
mělk	ces
melo	ell
membr	lat
mement	lat
memo	fra,lat
memorand	lat
mendík	lat
mén	ces
menhir	fra,bre
mening	lat,ell
meniskus	lat,ell
meno	ell
menšin	ces
menšitel	ces
menší	ces
menu	fra,lat
menuet	fra
merč	deu
merend	ita,lat
mergl	deu
merid	lat
meruň	lat
meruňk	lat
měsíčník	ces
měsíc	ces
smet	ces
mieść	ces
mestí	ces
mèsti	ces
mesti	ces
mest	spa,lat
meš	ces
mešug	deu
meta-	ell
forick	ell
forik	ell
metál	fra,ita,deu
metal	ell
morfóz	ell
stáz	ell
metér	fra,lat
metl	ces
metric	fra,ell
-metr	ell
metylén	deu,fra,ell
metyl	deu,fra,ell
mezan	fra,ita,lat
mezk	sqi
mezi	ces
mezu	deu,ita
mezulán	deu,ita
mi	ces
míc	ces
mičud	ces
migrén	deu,fra,lat,ell
míš	ces
míchan	ces
mik	jpn
mikro-	ell
mikrob	fra,ell
mili-	fra,lat
milý	ces
mimik	lat,ell
mimic	lat,ell
mimi	deu,eng,lat
mimo	ces
mimóz	lat,ell
minaret	deu,fra,tur,ara
mincíř	slk,deu
mindr	deu
mini-	lat
stryn	deu,fra,lat
ministr	deu,fra,lat
strant	deu,lat
miňon	fra
minorita1	deu,fra,eng,lat
minorita2	lat
prominout	ces
pominout	ces
minucióz	lat
minus	lat
minuskul	lat
měrn	ces
měřič	ces
mirakul	lat
-mírat	ces
miři	ces
misk	ces
misál	lat
misi	lat
miss	eng,fro,lat
místo	ces
mistryn	lat
míšeň	deu
mišmaš	deu
mišpul	lat,ell
mišug	deu
mišuňk	deu
-mítat	ces
mitr	lat,ell
mizantropický	fra,ell
mizantrop	fra,ell
mizer	ces
mizér	ces
mizera	ces
-mknout	ces
mláď	ces
mladic	ces
mladick	ces
mláka	ces
mlat	ces
mléč	ces
mlez	ces
mlhovky	ces
mlhov	ces
mlec	ces
mlet	ces
mlok	deu
mlsn	ces
pamlsek	ces
mlsoun	ces
mluvčí	ces
mówić	ces
mólviť	ces
mălvja	ces
mně	ces
mne	ces
mnemo	ell
mniš	ces
mnich	ces
mník	ces
mníti	pol,chu
mňouk	ces
mob	fra,lat
mocn	ces
modal	lat
modál	lat
modem	eng
moderát	deu,lat
modul	lat
moha	deu
medán	deu
mohér	eng,ara
mohutn	ces
mochn	ukr
mokasín	eng
mokro	ces
mol1	ces
mol2	ces
mol3	fra,lat
mold	ron
moloch	lat,ell,heb
mondén	fra,lat
monet	lat
monit	eng,lat
monitor	eng,lat
mono-	ell
monoftongiz	lat,ell
monoftong	lat,ell
monokl	deu,fra,lat
monolit	lat,ell
monsignor	ita,lat
monstr-	fra
monstranc	lat
monstróz	lat
monzun	deu,eng,ita,por,ara
mop	eng
moped	deu
mopslík	deu,nld
morov	ces
moral	lat
moratori	lat
morbid	fra,lat
morč	deu
mordije	fra,lat
mordi	fra,lat
mork	deu
morek	deu
moresy	lat
morfém	ell
morfemat	ell
morouský	lat
morous	lat
morse	eng
morta	ita,lat
mortal	lat
morytát	deu
přímoř	ces
mořit1	ces
moři	ces
mořit2	ces
můst	ces
moš	ces
ničk	ces
mošn	ces
moštárn	lat
motan	ces
moták	ces
smot	ces
motel	eng
motet	ita
moto-	deu,lat
motol	ces
motouz	ces
motovidl	ces
motyč	ces
motyk	ces
motýlek	ces
motýl	ces
moud	ces
moudř	ces
mouch	ces
mouk	ces
moul	ita,lat
mouř	lat
mozaik	deu,fra,ita,lat
mozk	ces
mozek	ces
možd	gmh,lat
nemravný	ces
mraž	ces
mrazn	ces
mráz	ces
mrh	ces
mršin	ces
mrkev	ces
mrml	ces
mrn	ces
mrť	ces
mrtvý	ces
mrv	ces
mrzák	ces
mrzk	ces
mřenk	ces
mrt	ces
mš	ces
mšic	ces
mudr	ces
muflon	fra,ita,lat
much	ces
moje	ces
muka	ces
mul1	ita,lat
mul2	deu,eng
mul	deu,spa
muld	deu,lat
multi-	lat
mumi	deu,ita,lat,ara,pes
mumraj	deu,fra,frm,spa
mundúr	deu,fra
munič	deu,frm,lat
munic	deu,frm,lat
můř	ces
muř	ces
murén	lat,ell
must	eng,spa
mustr	deu,ita,lat
mušká	gmh
muzej	deu,lat,ell
muzeál	deu,lat,ell
muze	deu,lat,ell
mydlinka	ces
mydl	ces
nedomykat	ces
myko	ell
myo	ell
kard	ell
myrh	lat,ell
myriád	deu,eng,ell
mys	rus
myslet	ces
myśl	ces
mysl’	ces
mîsao	ces
myslь	ces
mystéri	lat,ell
mysti	ell
myšk	ces
myšin	ces
myčk	ces
myt	lat,ell
myto	lat,ell
mž	ces
-ň	ces
na1	ces
na2	ces
nác	deu
-náct	ces
nad	ces
nadač	ces
nadac	ces
dir	ara
ňadr	ces
ňaf	ces
naftalín	deu,lat,ell,pes
náhl	ces
náhoda	ces
hraž	ces
nahot	ces
nah	ces
ch	ces
nach	ces
naivka	deu,fra,lat
jád	fra,ell
náme	ces
nand	spa
náplast	lat
napospas	ita
narkotik	ell
narkotic	ell
nark	ell
narkóz	ell
řaď	ces
naschvál	ces
-násob	ces
-násobný	ces
tal	lat
natož	ces
nátur	lat
naturel	fra
navigovat	lat
vigátor	lat
návladní	ces
zál	deu,lat
nazalizovat	deu,lat
naza	deu,lat
nazála	deu,lat
nazdar	ces
ne	ces
ně-	ces
nebešť	ces
nebo	ces
neboť	ces
bozíz	ces
boz	ces
cesér	fra,lat
neck	ces
mrl	ces
nedutat	ces
neg	lat
negac	lat
negliž	fra,lat
negr	deu,fra,spa,por,lat
gramot	rus,ell
negramot	rus,ell
negramotný	rus,ell
něh	rus
nehtík	ces
nehet	ces
nechť	ces
nej-	ces
nekalý	ces
kňub	ces
nekro-	ell
nekropol	ell
ktar	lat,ell
nektar	lat,ell
nelzon	eng
meh	ces
nemocný	ces
nemotora	ces
není	ces
neo-	ell
olit	ell
neol	ell
neo	ell
nervák	lat
nes	ces
nieść	ces
nestí	ces
nèsti	ces
nesti	ces
nestor	ell
nešpor	lat
nešť	ces
neštovicový	ces
švar	ces
netopýř	ces
netopýr	ces
netto	ita,lat
neuralg	lat,ell,deu
neuralgi	lat,ell,deu
neurast	ell
neuro-	ell
neur	lat,ell
neurot	lat,ell
neuróz	lat,ell
tron	lat
utron	lat
nevalný	ces
newton	eng
nezbeda	ces
ni	ces
nicotný	ces
nanic	ces
nic	ces
-nikat	ces
nikoli	ces
nikotin	deu,fra
nimb	lat
niněr	ces
nirv	ind
níst	ces
nitk	ces
niť	ces
zánět	ces
nitern	ces
nitro-	deu,lat,ell,egy
nizouč	ces
no	ces
nožn	ces
nok	deu
nokt	ita,lat
-nom	ell
nomenklatur	lat
nomenklat	lat
-nomie	ell
nonšalantní	lat
nonsens	lat
nonstop	lat
non-	lat
nonet	ita,lat
ius	por
nonsens	eng,fra,lat
nonstop	eng
šalanc	fra,lat
šalant	fra,lat
nopál	spa
nor	ces
nord	deu
nork	ces
norek	ces
norem	lat
nosič	ces
nót	eng,fra,lat
notabene	lat
notýsek	fra,eng
notes	fra,eng
notn	lat
nuzák	ces
novela1	ita,lat
novela2	lat
novick	lat
novici	lat
novic	lat
nozdr	ces
nuanc	fra,lat
nult	lat
numeric	ita,lat
nuncius	lat
nůsek	ces
nůš	ces
nutri	spa,lat
nutr	spa,lat
nuže	ces
nýbrž	ces
nymfo	lat,ell
nýt1	deu
nyv	ces
nýt2	ces
ó	ces
oáz	deu,lat,ell,egy
h2mbhi	ces
h1opi	ces
h1epi	ces
ob-	ces
oba	ces
bapol	ces
obecen	ces
obc	ces
obč	ces
obelisk	deu,lat,ell
oběš	ces
oběs	ces
oběť	ces
béz	lat
obezit	lat
obin	ces
láč	ces
oblak	ces
láz	ces
oblig	lat
obl	ces
b	ces
obut	ces
uv	ces
obř	ces
obrovit	ces
obrn	ces
obrněnec	ces
brtlík	ces
servat	lat
žer	ces
oc	ces
ocás	ces
ocelář	ces
octan	ces
ocet	ces
cún	ces
ód	deu,lat,ell
odér	fra,lat
děvn	ces
krágl	deu
odpustky	ces
dul	ces
ofic	deu,fra,lat
sajd	eng
ofsajd	eng
ogar	tur.
oharek	ces
ohař	ces
ohava	ces
ohb	ces
ohníč	ces
ohnic	ces
oheň	ces
ohon	pol
chechule	ces
ochoč	ces
chr	ces
-oid	eng,ell
oj	ces
ojoj	ces
o.k.	eng
karín	ita,lat
kazion	lat
okén	ces
okn	ces
okáč	ces
oko	ces
okolo	ces
koral	ces
okrs	ces
kří	ces
okř	ces
okřín	ces
oktáv	lat
oktet	ita,lat
oktroj	deu,fra,lat
okuje	ces
okul	deu,lat
okur	ces
okurk	ces
olbř	pol
oleandr	deu,ita,lat
olejnic	ces
olejn	ces
oligarch	ell
oliv	lat,ell
ověn	ces
ol	ces
olt	ces
oltář	ces
olympij	ell
ombuds	swe
omeg	ell
oměj	pol
omnibus	fra,lat
mše	ces
ond	fra,lat
ondul	fra,lat
one	ces
hd	ces
onomastik	ell
onomatopo	lat,ell
onto	ell
onuc	ces
onyx	lat,ell
opal	lat,ell
opar	ces
opat	lat,ell,arc
opč	lat
opc	lat
opič	ces
opic	ces
piát	lat,ell
opoz	lat
oppid	lat
prátk	ces
prať	ces
optic	lat,ell
opulent	lat
opus	lat
orál	lat
orangutan	zlm
oranžád	fra
oranž	fra
ornic	ces
oráč	ces
orb	ces
oratori	lat
orbit	lat
orel	ces
orgán	lat,ell
orgast	ell
orgasm	ell
org	deu,lat,ell
orchestrion	deu,fra,lat,ell
orchid	fra,lat,ell
originál	deu,lat
orkán	deu,nld,spa
orloj	lat,ell
orna	lat
ornament	lat
ornát	lat
oro-	ell
orsej	ces
ortel	gmh
orto-	ell
ortoep	ell
řech	ces
ořeš	ces
ořech	ces
oslic	ces
slátk	ces
osel	ces
osik	ces
osin	ces
osmin	ces
osmot	ell
smóz	ell
sůb	ces
ostnat	ces
osten	ces
osteo-	ell
stouz	ces
ostrak	ell
ostroh	ukr,chu
ostrův	ces
ostrov	ces
ostruh	ces
ostrost	ces
stříž	ces
ostříž	ces
ostých	ces
osud	ces
ošemet	ces
emet	ces
oškl	ces
ošlejch	gmh,lat
šuntě	deu,eng
otec	ces
oto	fra,ara
otorin	ell
otroč	ces
ouha	gmh,lat
oukl	ces
ouvej	gmh,lat
ouvert	fra,lat
ovac	lat
oveč	ces
ovčák	ces
ovčác	ces
ovc	ces
over	eng
oves	ces
ovšem	ces
vulač	lat
vul	lat
oxy	ell
ozon	ell
pa-	ces
pá-	ces
pȁ	ces
pack	deu,fra
pác	deu
fism	deu,fra,lat
padavka	ces
spadat	ces
vypadat	ces
pásti	ces
padu	ces
paděl	ces
padišáh	pes
padrť	ces
paf	deu
pagin	lat
pagod	deu,fra,por
katin	pol
zapáchat	ces
páchnout1	ces
páchnout2	ces
pajšl	deu
pajzl	deu,heb
pakliže	ces
páčk	ces
pakáž	deu
paklíč	ces
pako	deu
palač	slk,ron,lat
paland	rus,chu,lat
palaš	hun
palat	lat
palatál	lat
palc	ces
palčák	ces
palec	ces
paleo-	ell
paleo	ell
paleoli	ell
paleont	ell
paleta1	fra,ita,lat
paleta2	ita,lat
palet	deu,fra,frm
palic	ces
palisád	deu,fra,lat
paleb	ces
úpal	ces
palić	ces
palíť	ces
páliti	ces
paliti	ces
pálit1	ces
pálit2	ces
pálk	ces
pamfl	eng
pamp	spa
pampel	ces
pampeliš	ces
pan-	ell
panský	ces
pann	ces
paňác	ces
pancíř	gmh,fro,lat
panč	deu
panda	eng
pandán	fra,lat
ěr	spa,deu
pánv	lat,ell
pánev	lat,ell
pangejt	fra
panchart	gmh
pankový	eng
pank	eng
pankreas	ell
panoráma	deu,eng
panoš	ces
pansof	ell
panteon	ell
panter	deu,lat,ell
panto-	ell
pantofl	deu,ita
pantofel	deu,ita
omimic	deu,lat,ell
panychid	ell
papín	fra
papach	rus,tat
papá	ces
papil	lat
páprd	ces
paprik	srp,hrv
paprsk	ces
paprsek	ces
papul	lat
papundekl	deu
papyrus	gmh,fro,lat,ell
para-	ell
parn	ces
pařák	ces
desant	rus,fra,lat
paradigma	lat,ell
parafín	deu,lat
fín	deu,lat
leln	lat,ell
paralel	lat,ell
parale	lat,ell
paranoik	ell
parano	ell
paranoi	ell
parapet	fra,ita,lat
pl	fra,ita,lat
zit	lat,ell
parc	fra,lat
parcelac	fra,lat
parcel	fra,lat
parciál	deu,fra,lat
pardál	lat,ell
pardon	fra,lat
parentez	lat,ell
fém	fra,lat
parfém	fra,lat
parfumeri	fra
parchant	gmh
parč	fra,lat
parkán	gmh,lat
parkúr	fra
parm	deu,lat
parůžek	ces
parož	ces
partaj	deu,fra
parter	fra,lat
partes	lat
partitur	ita,lat
partnerk	eng,enm,fro,lat
partnerstv	eng,enm,fro,lat
party	eng,fra
paruk	ita
pařát	ces
pařez	ces
pas1	deu,frm
pas2	eng,fra,lat
pas3	fra
pásek	ces
pasát	deu,nld
pasáž	fra
pasažér	fra
pasaž	fra
pasek	ces
pasi	fra,lat
pasionál	lat
paskv	ita
pasovat1	ces
pasovat2	deu,dum,fra
pasák	ces
pastv	ces
pastevec	ces
pastor	lat
pastorek	ces
pašij	lat
pašije	lat
pašík	ces
pašk	lat,ell,heb
pašt	ces
patál	ita,lat
patén	lat,ell
patet	deu,ell
patin	ita,lat
patison	fra,lat
patka1	ces
patka3	deu,fra
patok	ces
patetik	deu,ell
patos	deu,ell
patriciát	lat
pauzák	deu
pav	gmh,lat
pavéz	ita
pavián	deu,nld,fra,frm
pavilon	deu,fra,fro,lat
pavuč	ces
pavouk	ces
pazdeř	ces
pecen	ces
pekáč	ces
pečeně	ces
piec	ces
peč’	ces
pȅći	ces
pešti	ces
pecič	ukr
ovic	ukr
pečárk	ces
bezpeč	ces
péč	ces
pečeť	ces
pedagogika	lat,ell
pedelský	lat
pedel	lat
peder	ell
tric	deu,ell
pediatr	deu,ell
pedo	ell
pech	deu
pejor	lat
pejzy	heb
pěkn	ces
pekt	ell
pektor	lat
pelargon	lat,ell
pelíš	ces
peler	fra,lat
pelest	deu
pelich	ces
pelik	lat,ell
pelmel	fra,fro,lat
pelo	fra,lat
pelyň	ces
pely	ces
pemz	rus,gml,lat
penál	deu,lat
penal	fra,lat
penále	fra,lat
penc	ang,deu
pendl	deu,lat
pendrek	deu
pěnic	ces
penis	lat
penta-	ell
peon	lat
pepita	spa
pepr	eng
mint	eng
peprmint	eng
peprn	lat,ell
pře-	lat
per-	lat
peren	lat
perfor	lat
pergamen	lat
pergol	ita,lat
peri-	ell
frast	lat,ell
peripeti	fra,ell
perkelt	hun
perkus	lat
leť	lat
perlík	ces
permon	deu
permut	lat
perník	lat,ell
pern	ces
pérk	ces
pírk	ces
pernat	ces
péř	ces
peron	deu,fra,fro,lat,ell
peroxid	deu,fra,ell
perpetuum	lat
perplex	deu,fra,lat
perspirace	lat
peruť	ces
zekv	lat
zek	lat
perz	deu
perzián	deu
perzifláž	fra,lat
perzist	lat
psí	ces
pejs	ces
psovsk	ces
pesar	lat,ell
peset	spa,lat
pesim	deu,fra,lat
pěs	ces
pěstoun	ces
pestř	ces
pěšec	ces
pěší	ces
pešunk	deu
pětk	ces
pět1	ces
pět2	ces
petard	deu,fra,lat
petic	deu,lat
petlic	ces
pett	eng
petún	lat
piastr	fra,ita,lat
pícn	ces
píc	ces
píč	ces
pidimužík	ces
piede	fra,ita,deu
pierot	fra
pifk	ces
pigl	deu
pig	deu,lat
pigment	deu,lat
pihat	ces
pih	ces
pichl	ces
píkati	ces
pīkati	ces
picháť	ces
pháti	ces
pьchati	ces
pichati	ces
pík	deu,fra
pikant	deu,fra
pikart	fra,nld
pikl	ces
piknik	eng,fra
pikola	ita
pikolík	ita
piksl	deu,lat,ell
pilk	ces
pilaf	tur,pes
pilíř	lat
píl	ces
pilot1	deu,fra,ita,ell
pilot2	deu,fra,lat
pilul	deu,lat
pinčl	deu
pinč	deu
pind	deu
pinď	deu
pingl	deu
pong	eng
ping-pong	eng
pini	lat
pint	deu,gmh,fra
pinzet	deu,fra,lat
pion	fra,fro,lat
piraň	por
pirož	rus
piroh	rus
piruet	fra,frm
píseč	ces
písek	ces
písň	ces
pískot	ces
pisk	ces
piskoř	ces
pisoár	fra
pistáci	lat,ell
pistác	lat,ell
pistolk	deu,fra
piš	deu
ingr	deu
píšťal	ces
píštěl	deu,lat
pitn	ces
pitk	ces
pítk	ces
piják	ces
pijác	ces
pit	ces
pitbul	eng
pitoresk	fra,ita,lat
pitvoř	ces
pizzový	ita
pizzer	ita
pizz	ita
pižm	lat,heb
plack	ces
pláč	ces
plahoč	ces
plách	ces
-pláchnout	ces
plakát	deu,dum,frm
plaket	deu,fra
plamín	ces
plameň	ces
-plán	lat,ell
pláň	gmh
plaňk	deu,gmh,lat
plankton	deu,ell
plást	ces
plastelín	deu
tičnost	deu,fra,lat,ell
plát1	ces
plát2	ces
płacić	ces
platíť	ces
plátiti	ces
platiti	ces
platonic	ell
plávať	ces
plâvati	ces
plavati	ces
play	eng
back	eng
plaz	ces
plazma	lat,ell
plíš	gmh
plejád	ell
plejboj	eng
plejtvák	ces
plenk	ces
plent	deu
plén	lat
pleon	lat,ell
spleť	ces
popleta	ces
plevel	ces
plexi	deu,lat
plez	deu,fra,fro,lat
plch	ces
plíč	ces
plic	ces
plíc	ces
plísň	ces
plíseň	ces
plísk	pol,lit,lat
plísn	ces
plis	fra,lat
plečk	ces
plít	ces
plíž	ces
plň	ces
plůd	ces
plonk	deu
ploštic	ces
plůtek	ces
plotic	ces
plotýn	deu
plova	ces
plsť	ces
plť	ces
pluch	ces
plundr	deu,nld
plusq	lat
plut	ell
plutoni	deu
pluv	lat
plynn	pol
plyt	ces
plytk	ces
-plývat	ces
plž	ces
pneum	lat,ell
pneu	ell
motorax	ell
pod	ces
podagr	lat,ell
bě	ces
láž	ces
podlah	ces
podle	pol
léš	ces
podloudník	ces
něc	ces
bizn	ces
podol	ces
půr	ces
drouš	deu
poem	lat,ell
etiz	lat,ell
poetiz	lat,ell
poeta	lat,ell
poez	deu,fra,lat,ell
pogrom	rus
hlavár	srp
hrouž	pol
hřb	ces
hříž	ces
hůn	ces
pochv	ces
point	fra,lat
pojk	ces
pokladní	ces
klic	ces
pokud	ces
pokut	ces
dník	ces
dnic	ces
polín	ces
polen	ces
policajt	deu
polič	ces
policej	lat,ell
poli	ell
polír	deu,fro
pólist	eng
polo	fra
néza	fra
polon	lat
polstr	deu
poluc	lat
poly-	ell
etylen	ell
etyl	ell
polyglot	ell
polyp	lat,ell
polysémick	ell
mád	deu,fra,ita,lat
-pomenout	ces
pomfrity	fra
-pomínat	ces
mláz	ces
mníč	ces
můc	ces
mpéz	lat
pomp	lat
ponč	spa
poněvadž	ces
poník	eng,gla
nrav	ces
ponu	pol
nur	pol
pop	ces
pop-music	eng
popelav	ces
popelín	deu,fra,eng
popkornový	eng
pkorn	eng
populariz	lat
pórk	gmh,lat
pór1	gmh,lat
réz	deu,lat,ell
pór2	deu,lat,ell
porce	deu,lat
portfej	fra,lat
rouč	ces
posel	ces
sesiv	lat
choď	ces
sléz	ces
slouch	ces
posuv	ces
post-	lat
poste restante	fra,lat
posthum	lat
postulát	lat
šmourn	ces
áck	deu,ita,lat
poštěváček	ces
poštolk	ces
šušň	fra
potn	ces
poc	ces
tent	lat
potkan	ces
tmě	deu,lat
tůč	ces
potraviny	ces
potřeba	ces
pouh	ces
poul	ces
evn	ces
pouť	ces
pouzdr	deu
věs	ces
věď	ces
zpověď	ces
póvl	deu,heb
vlov	ces
vřís	ces
zér	deu,fra,lat
pozič	lat
pozitron	lat,ell
pozoun	deu,gmh,fro,lat
pra-	ces
pracn	slv
pracující	slv
prác	slv
prack	deu,ita,lat
prá	ces
práh	ces
prah	ces
prak	ces
pramic	ces
pram	ces
prám	ces
pra	lat,ell
praporeč	rus
prasnic	ces
prasák	ces
sečkář	ces
praskl	ces
doprava	ces
výpravčí	ces
-pravit	ces
prax	deu,lat,ell
prázdno	ces
prázdnin	ces
žírn	ces
proprcat	ces
zprcat	ces
prc	ces
prč	ces
prdel	ces
prdelat	ces
proprdět	ces
při	lat
podrobnosti	lat
pre-	lat
ambule	lat
prebend	lat
precedens	lat
precl	gmh,lat
prefac	lat
prejt	deu
prekér	deu,fra,lat
prémiov	lat
prémie	lat
prem	fra,lat
premis	lat
natál	lat
prepoz	lat
rij	deu,eng,fra,fro,lat
préri	deu,eng,fra,fro,lat
presbyt	lat,ell
sump	lat
pretendent	lat
préterit	lat
prevenc	lat
prevít	lat
prezenč	lat
prezenc	lat
prézent	lat
prézens	lat
prezident	lat
prezidi	lat
prima1	lat
prima2	deu,ita,lat
primárk	deu,fra,lat
primariát	lat
primas	lat
primát1	lat
primát2	lat
primic	lat
principi	lat
princip	lat
principál	deu,lat
privát	deu,lat
privilegi	lat
prizm	deu,lat,ell
prkotin	ces
pro	lit,got,sga,lat,ell
pro-1	lat,ell
pro-2	lat
bošt	lat
procedur	deu,fra,fro,lat
proced	deu,fra,fro,lat
procent	deu,ita,lat
proč	ces
profil	deu,fra,ita,lat
fylakt	ell
fylax	ell
hibič	lat
kurat	lat
lákl	ces
promile	deu,ita,lat
promotor	lat
promoc	lat
promptn	deu,fra,lat
propan	ell
propriety	fra,lat
prorokyn	ces
roctv	ces
prorok	ces
prosinc	ces
prosinec	ces
prosb	ces
skur	rus,ell
prosn	ces
stitutk	lat
páš	ces
stor	ces
stranstv	ces
šustr	deu
protag	ell
tein	ell
protein	ell
tež	fra,lat
protiv	ces
protiva	ces
proti	ces
proto-	ell
protokol	deu,lat,ell
plazm	lat,ell
proudit	ces
zaik	deu,lat
prozaický	deu,lat
próz	deu,lat
zod	lat,ell
zód	lat,ell
prsa	ces
prsn	ces
prsat	ces
podprsenk	ces
předprseň	ces
prska	ces
prsť	ces
prstýn	ces
spršk	ces
sprch	ces
průb	deu,lat
pruch	deu
prou	ces
proutk	ces
prut	ces
pružin	ces
senk	pol
první	ces
prven	ces
prý	ces
pryč	ces
pryčn	deu
prým	gmh
pryskyřič	ces
prýšt	ces
prz	ces
-přáhnout	ces
přac	ces
přejíc	ces
prze-	ces
pere-	ces
pře-	ces
přece	ces
předek	ces
představený	deu
přehršl	ces
přes	ces
slic	ces
převor	ces
zdí	ces
zk	ces
přezk	ces
ůvk	ces
při	ces
příbuz	ces
příbuzný	ces
příč	ces
příjic	deu
přilb	ces
příliš	ces
přirozený	ces
přirozenost	ces
sež	ces
přad	ces
příz	ces
přást	ces
přís	ces
příšt	ces
přátel	ces
tel	ces
nepřátelský	ces
přítrž	ces
zniv	ces
přízeň	ces
nade	ces
pisać	ces
pisáť	ces
písati	ces
pьsati	ces
pseudo-	ell
pstruž	ces
psycho-	ell
ptáček	ces
ptac	ces
pter	ell
odaktyl	ell
pub	lat
escent	lat
pudl	deu
pudř	deu,fra,fro,lat
pugé	deu,fra,fro,deu
puchl	ces
puchř	ces
puk1	deu
puk2	eng
pukrl	deu
pulír	deu,fra,lat
ovr	eng
pulp	deu,lat
puls	deu,lat
pultík	deu,lat
pum	ces
puma2	ces
punč	deu,eng
punčoš	deu
punk	eng
puntíč	gmh,lat
pupík	ces
pupín	ces
pupen	ces
pupil	lat
purist	fra,lat
purkmistr	gmh,lat
půst	ces
propusť	ces
pusť	ces
puškvor	deu
půtk	ces
putyk	deu,lat,ell
puzzl	eng
pyš	ces
pých	ces
pyj	ces
pyk	ces
pyknic	ell
pyknik	ell
pylon	ell
pýr	ces
pyré	fra,fro,lat
pyrit	ell
pyro-	ell
pytlík	gmh
pytlác	gmh
pytel	gmh
rabsk	ces
rabi	deu,lat
rabiát	deu,lat
rabiák	deu,lat
racek	ces
racional	lat
radní	ces
rada	ces
radar	eng
radikál	deu,fra,lat
radio-	deu,eng,lat
radl	ces
radon	eng,ell
raf	deu
ráf	deu,deu
rafije	lat,ell
ragby	eng
raglán	eng
ragtime	eng
rag	fra,lat
ráh	deu
rách	ces
rachot	ces
racht	ces
rajsk	ces
ráj	ces
rajčat	deu,lat,ell
raj	deu,lat,ell
rajk	deu,lat
rajt	deu
rak	ces
raketa1	deu,ita
raketa2	deu,fra,ita,ara
rakv	ces
rakev	ces
rakije	srp,hrv,tur,ara
rallye	eng,fra
ramín	ces
raněný	ces
rán	ces
ranč	eng,spa,fra,deu
randál	deu
rand	deu,fra,lat
raneč	deu
ranec	deu
ráno	ces
rantl	deu
raper	eng
rapid	deu,fra,lat
rapír	deu,fra
raplovský	deu
rapl	deu
raport	deu,fra,lat
rapsod	lat,ell
rar	lat
raroh	ces
rastr	deu,lat
raš	ces
ratan	eng,zlm
ratejn	ces
ratolest	ces
raub	deu
raut	eng,fro,lat
razi	deu,fra,ara
ráže1	ces
ráže2	fra,lat
rdesn	ces
rd	ces
rdous	ces
re-	lat
aktor	eng
reáli	lat
reál	lat
rébus	deu,fra,lat
cenzent	deu,lat
recepční	deu,lat
cepc	deu,lat
rece	lat
recept	lat
recese	lat
reci	lat
citál	lat
redakč	deu,fra
redakt	deu,fra
redakc	deu,fra
ig	deu,fra,lat
reduplik	lat
frén	fra,fro,lat
fýž	fra,lat
regál	deu
regat	ita
regenschor	lat
regent	deu,lat
regiment	deu,fra,lat
registrat	lat
regist	lat
regres	lat
regulátor	lat
rehek	ces
recht	deu,lat,ell
rej	gmh,fro
rejnok	deu
rejs	ces
rejstř	lat
rejtar	deu
rejž	gmh,lat
rekc	lat
konvalescent	deu,lat
konvalesc	deu,lat
rekvi	lat
relač	lat
relac	lat
relé	fra,fro,lat
ligioz	lat
ligion	lat
ligióz	lat
relikv	lat
rely	eng,fra
remc	ces
reminiscenc	deu,lat
remork	fra,lat,ell
rempl	deu
remul	deu,fra
rendl	deu
reneg	deu,fra,ita,lat
renet	deu,fra,fro,lat
renom	fra,lat
renomé	fra,lat
renonc	fra,lat
reo	ell
repert	fra,lat
repete	lat
presál	deu,lat
repríz	fra,lat
reprobac	lat
duktor	lat
reput	lat
resekc	lat
respektive	lat
respir	lat
restaurant	deu,fra
strikč	lat
strikc	lat
resum	fra,lat
rešerš	fra,lat
retn	ces
rtěnk	ces
tard	lat
retard	lat
retro-	lat
retuš	deu,fra,lat
veň	rus,tur,pes
reveň	rus,tur,pes
revolt	deu,fra,ita,lat
revoluc	deu,lat
revuál	fra,lat
revu	fra,lat
rezat	ces
rezed	deu,lat
zervn	deu,fra,lat
rezidenc	lat
zid	lat
rezoluc	lat
zultá	deu,fra,lat
režij	fra,lat
režim	fra,lat
rigol	fra,dum,lat
rigor	lat
rigoróz	lat
rikša	deu,jpn
ritus	lat
riviér	ita,lat
rizot	ita
rmen	ces
roaj	fra,lat
rób	deu,fra,frk
robinzon	eng
robust	deu,lat
rockersk	eng
rodn	ces
narození	ces
narozeniny	ces
enec	ces
zrození	ces
rôd	ces
rodъ	ces
rode	eng,spa,lat
rododendron	lat,ell
roho	ces
rochně	ces
roklin	ces
rokl	ces
rokok	deu,fra,lat
rolád	fra
role1	deu,fro,lat
role2	ces
rolet	deu,fra
romadúr	deu,fra
roman	deu,fra,fro
romanc	deu,fra,spa
romanet	ita
ropn	pol
ropuch	pol
rorát	lat
rorýs	ces
rošád	deu,gmh,fro,spa,pes
rotor	lat
rotac	lat
rotund	lat
rouh	ces
rouš	ces
roun	ces
roup	deu
rous	ces
rout	lat,ell
rovněž	ces
rovink	ces
rovnic	ces
rovnátka	ces
rovň	ces
roz-	ces
raz-	ces
břesk	ces
rozet	fra
pliz	ces
polc	ces
polt	ces
ptyl	ces
šmelc	deu
tomil	ces
rozum	ces
vern	ces
rubl	rus
rubr	deu,lat
rudi	lat
jeť	ces
rukojmí	ces
ruksak	deu
rulád	fra
rulandské	deu
rulanda	deu
rulet	fra,fro,lat
ruličk	deu,fra
rulík	ces
rumišt	gmh
rum1	gmh
rum	deu,eng
rum2	deu,eng
rumb	spa,lat,ell
ruměl	ces
rumpál	deu
rumpl	deu
rumrajch	deu,fra,frm,spa
rumraj	deu,fra,frm,spa
rund	deu,fra,lat
rusal	rus,orv,lat
srůst	ces
vzrůst	ces
róść	ces
rásti	ces
rasti	ces
rustikál	deu,lat
vzruch	ces
růžic	ces
růžen	deu,lat
rybin	ces
ryk	ces
ryč	ces
rychlík	ces
rynek	gmh
ryn	gmh
ryngl	deu
rys1	ces
rysk	deu
ovadl	deu
rys2	deu
rýč	ces
rytin	ces
rytmik	lat,ell
rytm	lat,ell
ryzl	deu
rž	ces
řach	ces
řapík	ces
řasnat	ces
řebř	ces
ředk	ces
řehn	ces
řehot	ces
říčk	ces
řemín	ces
řem	ces
řemen	ces
řepk	ces
řepn	ces
řepíč	ces
řeř	ces
řeřich	ces
řevn	ces
řezn	ces
řezb	ces
rzezać	ces
rézať	ces
rȅzati	ces
říka	ces
odříci/odřeknout	ces
řéci	ces
rzec	ces
rečí	ces
rȅći	ces
řič	ces
řídítka	ces
nadřízený	ces
podřízený	ces
řiz	ces
říms	gmh,lat
řinč	ces
řin	ces
říšsk	deu
říš	deu
řit	ces
řiť	ces
řít	ces
řev	ces
s	sga,ell
sabotér	fra
sadzić	ces
sadíť	ces
sáditi	ces
saditi	ces
sádel	ces
safari	eng,swa,ara
saž	ces
sacharin	deu,lat,ell
sajdk	eng
sajrajt	deu
sajtn	deu
saké	jpn
-sáknout	ces
sakr	lat
sakra	lat
sakrál	deu,lat
sakrist	lat
sakum	ces
sakur	jpn
salamandr	gmh,lat,ell
salaš	hun
sald	deu,ita,lat
salmiak	deu,lat
saltový	ita,lat
salt	ita,lat
salut	deu,lat
salv	deu,fra,ita,lat
samb	por
samic	ces
samič	ces
samec	ces
samuraj	jpn
saň	ces
sanač	lat
sanatori	deu,lat
sangvin	deu,lat
sangvinik	deu,lat
sanitk	deu,fra,lat
sankč	deu,fra,lat
sanskrt	deu,eng
santal	fra,lat
sáp	ces
sapér	fra,lat
sapristi	lat
saranče	rus,tur
sardin	deu,ita
sardon	fra,lat,ell
sarkast	deu,lat,ell
sark	deu,lat,ell
sarkofág	lat,ell
sarkom	deu,lat,ell
sac	ces
savec	ces
satiric	lat
satir	lat
satis	lat
fakc	lat
satur	lat
sat	lat
satyr	lat,ell
saun	fin
sazár	ces
sázen	ces
sažáť	ces
sběř	ces
science fiction	eng
se-	lat
seanc	fra,lat
sedan	eng
sez	ces
přísedící	ces
neposeda	ces
siedzieć	ces
sidéť	ces
sjèdeti	ces
sèdeti	ces
sěděti	ces
sedi	deu,lat
selk	ces
selsk	ces
sedmer	ces
segregac	lat
seizm	ell
sejf	eng,fro,lat
seka	ces
sekáč	ces
výseč	ces
sieci	ces
siec	ces
seč’	ces
sjȅći	ces
sȅći	ces
sekč	deu,lat
sekc	deu,lat
seker	ces
sekrec	lat
sekreč	lat
sekretář	lat
sekul	lat
sekular	lat
sekvenc	lat
sekvoj	eng
ladon	fra
látk	deu
ekč	deu,lat
semafor	deu,fra,ell
sémant	ell
sém	ell
arist	deu,lat
sniv	ces
sníl	ces
senátor	lat
sendv	eng
senilit	lat
senil	lat
senn	ces
seník	ces
sentenc	lat
sentinel	eng,fra
senzač	deu,fra,lat
senzit	lat
sept	deu,ell
seps	deu,ell
septim	lat
serafín	lat,ell,heb
seren	deu,fra,ita,lat
serpentin	deu,lat
servír	deu,fra,lat
servis	lat
servus	deu,lat
serž	fra,fro,lat
střičk	ces
sester	ces
sestř	ces
sestr	ces
setr	eng
seveř	ces
sexy	eng,lat
sex-appeal	eng,lat
sextant	lat
zam	deu,lat,ell
sezam	deu,lat,ell
sezon	deu,fra,lat
show	eng
schém	deu,lat,ell
scherz	ita,deu
schizm	lat,ell
schl	ces
sch	ces
-si	ces
sibér	fra,tat
sice	ces
sien	ita
siest	spa,lat
sifon	deu,fra,lat,ell
signál	deu,fra,lat
sígr	deu
sichr	deu,lat
silác	ces
-sílat	ces
silik	lat
siluet	fra
sím	ces
simultán	lat
singulár	lat
singul	lat
síp	ces
sirn	ces
síran	ces
síř	ces
sirén	deu,fra,lat,ell
siř	ces
tí	ces
setb	ces
sé	ces
síťk	ces
sítk	ces
siv	ces
ska	fra,ell
fandr	fra,ell
skák	ces
skalk	ces
skál	ces
skalár	lat
skalpel	lat
skandál	deu,lat,ell
skanzen	swe
skateboard	eng
skautk	eng,fro,lat
skeč	eng
skelet	deu,ell
skeps	deu,ell
sket	ces
ski	eng,nor,isl
skifař	eng,fra,ita,lng,deu
skif	eng,fra,ita,lng,deu
skin	eng
head	eng
skinhead	eng
sklíp	ces
skler	ell
skeln	ces
klář	ces
klárn	ces
sklenk	ces
klo	ces
skokan	ces
poskok	ces
sk	ces
výskok	ces
skoczyć	ces
skočíť	ces
skòčiti	ces
skočiti	ces
skolióz	ell
-skop	ell
kopč	deu
skór	eng,isl
skóre	eng,isl
skorec	ces
skoro	ces
skořepin	ces
skořáp	ces
skráň	ces
skrblík	ces
skrblick	ces
skrb	ces
skromn	pol
skrovn	pol
skrum	eng,fro
krupu	lat
krupul	lat
krutini	lat
skrz	ces
skřehot	ces
skřeh	ces
skřek	ces
skřel	pol
skříňk	lat
skřip	ces
skřet	goh
skřít	goh
skuč	ces
skuhra	ces
skuhr	ces
kulptur	deu,lat
skunk	eng
skutk	ces
skutek	ces
skútr	eng
skvě	ces
skv	ces
skvrnk	ces
skvrnit	ces
skvrn	ces
skyt	ces
skýt	ces
skýv	ces
slabič	lat,ell
slaboš	ces
slaďák	ces
omář	nor
slaměn	ces
slamák	ces
slang	eng
slap	slv,srp,hrv
-slat	ces
sláv	ces
slavíč	ces
slavík	ces
sleč	ces
slečn	ces
sleďový	pol,rus,deu
sleď	pol,rus,deu
slepič	ces
lípk	ces
slepýš	ces
slez	ces
slib	ces
slič	ces
slim	ces
slín	ces
slintav	ces
slív	ces
sliznat	ces
slogan	eng,gla
sloh	rus
sloj	ces
slok	ces
slůn	ces
slot	ces
slou	ces
Slov	ces
slovan	ces
Slovan	ces
slovesn	lat
sloves	lat
slův	ces
násl	ces
oslov	ces
slovutn	ces
slouh	ces
služebný	ces
sługa	ces
slugá	ces
slúga	ces
sluga	ces
sluj	ces
sluk	ces
sly	ces
słyszeć	ces
slýšať	ces
̏šati	ces
slyšati	ces
slzn	ces
smaž	ces
smá	ces
smečk	ces
smě	ces
smíšek	ces
směch	ces
smích	ces
smiln	ces
smoking	eng
smok	eng
mokvoň	srp,hrv
smraď	ces
smrč	ces
mrč	ces
smršť	rus
smrž	ces
smoln	ces
smolař	ces
smolinec	ces
myč	ces
mýč	ces
snadn	ces
snad	ces
snah	ces
snach	ces
snajpr	eng
něd	ces
snědnout	ces
sněd	ces
sněť	ces
ulák	ces
sníh	ces
snítk	deu
snob	eng
snoub	pol
snov	ces
snůš	ces
sobolový	rus
sobol	rus
social	deu,fra,lat
war	eng
soš	ces
sousoš	ces
sochor	ces
sojč	ces
sojk	ces
sokyn	ces
soč	ces
sok	ces
sokl	deu,fra,ita,lat
solári	lat
sold	deu,fra,ita,lat
solitér	fra,lat
sólist	ita,lat
sombrer	spa,lat
sondážn	deu,fra
sonet	ita,lat
song	eng
sonorita	deu,fra,lat
sonor	deu,fra,lat
sopel	ces
sopk	rus,orv
sopouch	ces
so	ita,lat
prán	ita,lat
sopra	ita,lat
sopt	ces
sort	ita,lat
sortiment	ita,lat
sosák	ces
sotně	ces
setně	ces
sotva	ces
sou-	ces
soukrom	ces
sous	ces
souš	ces
těsk	ces
-souvat	ces
sův	ces
span	ces
spartán	ell
fic	lat
spíkr	eng
spinet	deu,ita,lat
spirituál	eng,lat
spíše	ces
spíš	ces
spižírn	gmh,lat
spíž	gmh,lat
plask	ces
splín	eng,fro,lat,ell
spodek	ces
pojler	eng
spolu	ces
spontane	lat
sportk	eng,fro,lat
spot	eng
spoust	ces
sprat	ces
sprejer	eng
squatter	eng,fro,lat
srabit	ces
srab	ces
srdč	ces
srkav	ces
srk	ces
srnk	ces
srnec	ces
srneč	ces
srnč	ces
srn	ces
srpek	ces
srpen	ces
srstnat	ces
srst	ces
sršeň	ces
staccato	ita,deu
stacion	lat
stadion	deu,ell
stadi	lat,ell
stafáž	deu,dum,fro
fyl	ell
stafylokok	ell
stalakt	ell
stán	ces
standart	deu,fro
staniol	deu,ita,lat
startér	eng
starý	ces
stařešina	srp,hrv
stať	rus
stát1	lat
stojk	ces
stát2	ces
stát se	ces
stativ	deu,lat
statut	lat
stáv	ces
stážist	fra,lat
stéb	ces
steeplech	eng,fra,lat
stehlík	ces
stehen	ces
stehn	ces
stejk	eng
stejšn	eng
nástěnk	ces
stěnek	ces
sten	rus
steno-	ell
stereo-	ell
steroid	ell
stet	ell
stevardk	eng,ang
stevardský	eng,ang
stevard	eng,ang
stezk	ces
stigm	ell
stinn	ces
nástin	ces
stipendij	lat
stipendi	lat
stodol	goh
stoh	ces
sto	ell
stoik	ell
stok	ces
story	eng,fro,lat
-stoupit	ces
sestup	ces
stąpać	ces
stupáť	ces
stúpati	ces
stǫpati	ces
stožár	ces
strašák	ces
strach	ces
strač	ces
strakapoud	ces
stráň	ces
stranou	ces
stratég	ell
strateg	ell
strategie	ell
strati	lat
strat	lat
strážný	ces
straž	ces
nástrah	ces
ostrah	ces
ostraž	ces
strah	ces
strd	ces
strept	ell
streptokok	ell
strepto	ell
striktn	deu,lat
stript	eng
striptýz	eng
strkanic	ces
strnad	ces
strnisk	ces
strništ	ces
stroboskopie	ell
strobo	ell
strojnic	ces
strůjc	ces
stronc	lat
strouž	ces
struk	ces
al	lat
strum	lat
strunk	ces
stroup	ces
strýč	ces
strejd	ces
strýc	ces
strychn	fra,ell
strž	ces
střad	ces
střeč	ces
śródek	ces
seredína	ces
srijéda	ces
sréda	ces
srěda	ces
stříšk	ces
střech	ces
stř	ces
strzała	ces
strelá	ces
strěla	ces
stře	ces
střem	rus,chu
střemch	ces
střenk	ces
stříp	ces
střep	ces
střet	ces
střevíč	ces
střív	ces
střež	ces
vystřihovánky	ces
střihu	ces
ostříknout	ces
-střít	ces
střízliv	ces
studi	deu,ita,lat
stuž	ces
stuh	ces
stůl	ces
stul	ces
stupín	ces
stvol	rus
stvůr	ces
týsk	pol
sub-	lat
subret	fra,lat
skrib	lat
stanč	lat
strát	deu,lat
str	deu,lat
sudl	ces
sufix	deu,lat
sufražet	eng,lat
sugesc	lat
sugest	lat
ger	lat
sušárn	ces
suchar	ces
suit	fra,fro,lat
souč	ces
sukýn	ces
sukň	ces
ken	ces
sůl	ces
sulcovatý	deu
sulf	lat
sultanát	tur,ara,arc
sumec	ces
sumk	pol,rus
summ	eng,fra,fro,lat
sesuv	ces
vsunout	ces
sunąć	ces
super-	lat
superior	lat
suplik	deu,lat
surreal	fra
suř	rus,ell
pend	lat
penzor	eng,lat
sutiny	ces
suť	ces
sutan	fra,ita,lat
suvenýr	fra,fro,lat
suveren	fra,lat
suverén	fra,lat
svalnatět	ces
svár	ces
svateb	ces
svatb	ces
svatý	ces
veřepost	ces
veřep	ces
světlo	ces
svetř	eng
svetr	eng
svíč	ces
svíd	ces
svidř	ces
sviňk	ces
svinč	ces
svišť	pol
svist	ces
svišt	ces
svitek	ces
świecić	ces
svetíť	ces
svijétiti	ces
svétiti	ces
světiti	ces
svíz	ces
svízel	ces
svižn	ces
vlač	ces
svobodárn	ces
svoboz	ces
svor	ces
svrb	ces
svršek	ces
svůj	ces
swing	eng
sýč	ces
syč	ces
syfilit	ces
syfil	ces
syfilis	ces
sychr	ces
sychra	ces
sylabus	lat,ell
symbióz	ell
symbo	deu,lat,ell
sympozi	deu,eng,lat,ell
sympto	deu,ell
symptom	deu,ell
synek	ces
áček	ces
ovec	ces
syn-	ell
synagog	lat,ell
syndrom	deu,ell
kopick	deu,lat,ell
synkretik	lat,ell
synodick	lat,ell
synod	lat,ell
synopt	lat,ell
synops	lat,ell
tagm	deu,ell
syntagma	deu,ell
syntaktik	deu,lat,ell
sep	ces
výsp	ces
sysel	ces
syž	fra,lat
šáb	deu
šac	deu
šafář	gmh
šafrán	gmh,fra,lat,ara
šáh	pes
šachet	deu
šajnit	deu
šajn	deu
šajtl	deu
šálek	deu
šáliv	ces
šalb	ces
šaleb	ces
šalmaj	gmh,fro,lat
šalotk	deu,fra,fro,lat
šal	deu
šaltr	deu
šalup	deu,fra
šalvěj	gmh,lat
šampus	fra
šampaň	fra
šampionát	fra,lat,deu
šance1	deu,fra,lat
šance2	deu
šanon	deu,eng
šan	gmh
šapit	fra,lat
šaramant	deu,fra
šar	deu,fra
šarád	fra
šarlat	gmh,fro,lat,pes,ara
šarla	gmh,fro,lat,pes,ara
šarlatán	deu,fra,ita
šarm	fra,fro,lat
šarvát	deu
šarž	deu,fra,lat
šasi	fra,lat
šašl	rus,tat
šatn	deu
šatl	deu,fra,lat
šéfk	deu,fra,fro,lat
šejk	eng,fra,ara
šejkr	eng
šla	ces
šel	ces
šen	gmh
šepot	ces
šereda	ces
šered	ces
šerpa	deu,fra,fro,lat
šeř	ces
šeřík	ces
šest	ces
ševel	ces
šibal	ces
šíb	deu
šibř	deu,gmh
šiz	ces
šídl	ces
šífař	deu,deu
šíf	deu,deu
šifon	fra
šicht	deu
šik1	gmh
šik2	deu,fra
šilink	gmh
šiml	deu
šín	deu
šípk	ces
šípek	ces
šišák	ces
šišt	ces
šišk	ces
šicí	ces
šičk	ces
šiv	ces
podšívka	ces
výšiv	ces
škád	ces
škádl	ces
škál	deu,ita,lat
škamn	lat,deu
škapulíř	deu,lat
škár	ces
škar	ces
škared	ces
škarp	ita
škemrav	ces
škemr	ces
škleb	ces
škodn	goh
škůd	goh
školk	ces
škop	lat,ell
škor	ces
škorpion	deu,lat,ell
škorp	ces
škrabanin	ces
škrabk	ces
škrabák	ces
škral	ces
škrkavk	ces
škrobárn	ces
škrobáren	ces
škrobár	ces
škrpál	ita
škrund	ces
škubánky	ces
škuner	eng
škvar	ces
škvark	ces
škvor	ces
škvr	ces
šlágr	deu
šlah	ces
šlajfk	deu
šlajsn	deu,lat
šlak	deu
šlamastyk	deu
šlauch	deu
šl	ces
šlem	deu
šlendrián	deu
šlép	ces
šlicht	deu
šlof	deu
šlup	ces
šlus	deu
šmah	ces
šmajchl	deu
šmat	ces
šmaťh	ces
šmátr	ces
šmidl	ces
šmink	deu
šmirgl	deu,ita,ell
šmírák	deu,heb
šmolk	deu
šmouhovatý	ces
šmrd	ces
šmudla	deu
šmuk	deu
šnaps	deu
šneč	deu
vadl	deu,gmh
šnorch	deu
šňůrk	gmh
šňůr	gmh
šnyt	deu
šod	fra,lat
šof	deu,fra
šohaj	slk
šortk	eng
šosat	deu
šosák	deu
šosác	deu
šos	deu
šošol	ces
šot	eng
šotolin	ita,deu
šoul	ces
šoupál	ces
šoust	ces
špac	deu,ita,lat
špacír	deu,ita,lat
špaček	ces
špag	ita
špagety	deu,ita
špachtl	deu,lat,ell
špajz	deu
špald	deu
špalík	ces
špalíč	ces
špal	ces
špalír	deu,ita,lat
špat	ces
špatn	ces
špehýr	gmh,eng,lat,ell
špejchar	deu,gmh
špeluňk	deu,lat,ell
špendlík1	gmh,lat
špendlík2	gmh
šperhák	deu
špetk	ces
špic	gmh
špicl1	deu
špicl	deu
špicl2	deu
špik	deu
špín	ces
špirit	deu,lat
špitál	gmh,lat
špíz	deu
šplouch	ces
šprajc	deu
šproch	deu
šprot	deu
šprťouchlata	deu
špulk	deu
špumprnádle	deu,ita
špunt	gmh
šrajt	deu
ofl	deu
šrám	gmh
šramot	ces
šraňk	deu
šrapne	deu,eng
šrot	deu
šrot1	deu
šrot2	deu
šrůtk	ces
štac	deu,lat
štajf	deu
štajgr	deu
štamgast	deu
štamprle	deu
štandopede	lat
štangl	deu
šťav	ces
šťáv	ces
šťavel	rus
štel	deu
štempl	deu
štěň	ces
štíh	ces
štíhl	ces
štič	ces
štik	ces
štiplav	ces
štítn	ces
štkav	ces
štoč	deu
štok	deu
štokrle	deu
štól	lat
štolb	deu
štorc	deu
štos	deu
štoud	goh
šťuch	deu
šťovík	ces
štrád	ita,lat
štráf	deu
štrách	deu
štramand	deu
štram	deu
štrap	deu,ita
štrejch	deu
štrek	deu
štrik	deu
štrozok	deu
štrúd	deu
štůč	ces
štuk	gmh
štul	ces
štulpn	deu,gml
štup	deu
šturm	gmh
štych	deu
štym	deu
šub	gmh,ita,ara
šufán	deu
šufan	deu
šuhaj	slk
šuk	ces
šumic	ces
šumiv	ces
šumák	ces
šuměn	ces
šumař	ces
šumn	pol
šunt	deu,eng
šupajd	ces
šupink	deu
šuplík	deu
šupl	deu
šus	deu
šuspajtl	deu
šváb	deu
švab	deu
švand	deu
švarn	ces
ševc	ces
švest	ces
švestk	ces
švihák	ces
švitoř	deu
švunk	deu
tabat	fra
tabletennis	eng
table-tennis	eng
tabl	fra
tábo	ces
ř	ces
táboř	ces
taburet	fra,fro,frm
tácek	deu,ita,ara
tác	deu,ita,ara
tady	ces
tág	deu,spa
tahac	ces
tahan	ces
taha	ces
táhl	ces
stah	ces
vtáhnout	ces
ciągnąć	ces
tjanúť	ces
tajfunový	zho
tajfun	zho
tajg	rus
tajný	ces
tajl	deu,fra,lat
tajtr	gmh
taký	ces
také	ces
takřk	ces
takt1	deu,lat
takt2	deu,fra,lat
talár	deu,lat
talis	deu,fra,eng,spa,ara,ell
talm	heb
talon	fra,lat
tambor	deu,fra,fro
tamburín	deu,fra
tampon	deu,fra,frk
tamtam	fra
taneční	gmh,fro
tanc	gmh,fro
předtančení	gmh,fro
dance	gmh,fro
tanec	gmh,fro
tangens	dan,lat
tanker	eng
tan	ces
tant	fra,lat
ťáp	ces
tapet	deu,lat,ell
tapír	lat
tapiser	fra,ell
tarantul	deu,ita
tarasnic	gmh,fro
tarif	deu,ita,ara
tar	deu,ita
tasem	pol,tur
tas	ces
tašt	goh
tán	ces
tá	ces
tať	ces
tatrman	gmh
taut	lat,ell
tavern	gmh,ita,lat
taven	ces
tavír	ces
tavol	rus,tat
taxik	deu,fra,eng
taxi	deu,fra,eng
táz	ces
té	deu,nld,zho
tebich	deu,lat
otok	ces
přítok	ces
ciec	ces
teč’	ces
tȅći	ces
tešti	ces
tečn	dan,lat
teď	ces
tedy	ces
těhotn	ces
techtl	deu,ita,lat
teist	ell
telecí	ces
tele-	ell
teleo	lat,ell
ísk	ces
vizor	fra,eng
telex	eng
tellur	lat
tém	deu,lat,ell
témbr	fra,ell
temen	ces
téměř	ces
temperat	deu,lat
tendenč	deu,fra,lat
tendenc	deu,fra,lat
tendr1	eng,fra,lat
tendr2	eng,fra,lat
tenisk	eng,enm,fra,lat
teo-	ell
teplo	ces
tepl	ces
teprv	ces
tequil	spa
tér	deu,eng
terári	lat
terci	lat
terc	lat
terčík	gmh,fro,deu,ang,deu
teritor	lat
teritori	lat
termik	deu
termín1	lat
termín2	deu,lat
termit	lat
termo-	ell
terpentýn	ces
tesák	ces
těs	ces
těsnic	ces
testament	lat
těch	ces
tetk	ces
tetan	lat,ell
tetanus	lat,ell
tetel	ces
tět	ces
tetra-	ell
tetří	ces
tetřev	ces
textař	lat
teza	lat,ell
tezaur	lat,ell
též	ces
thriller	eng
tchyn	ces
tchán	ces
tiár	lat,ell,pes
ticho	ces
tiket	eng,fro
tingl	deu
tangl	deu
tinkt	lat
tint	ces
tipl	lat
tiptop	eng
tirád	deu,fra
-tírat	ces
tiráž	fra
tiret	fra
tis	ces
tísň	ces
tíseň	ces
tisící	ces
tišt	ces
tískať	ces
tít	ces
-tkat	ces
tkv	pol
vztlak	ces
tłoczyć	ces
tláčiti	ces
tlačiti	ces
tlam	ces
tlamp	ces
tl	ces
tlukot	ces
tlumen	pol
tlumok	ces
tlup	ces
tloušť	ces
tloušt	ces
tlusť	ces
tloust	ces
tlust	ces
temn	ces
tmav	ces
tobogan	deu,eng
tobol	ces
točn	ces
tóg	lat
tokaj	hun
tolar	deu
tolerant	deu,fra,lat
toleranc	deu,fra,lat
toler	deu,fra,lat
tolik	ces
tomat	deu,fra,spa
tombol	ita
tonáž	fra,eng
tonik	eng,ell
tonoucí	ces
tonus	lat,ell
tonzur	lat
top-	eng
topán	hun
topi	ces
topit1	ces
potop	ces
topit2	ces
topol	ces
nomast	ell
topůr	ces
tór	heb
torb	pol,tur
toreador	spa,lat
torn	deu
tort	lat
torz	ita,lat,ell
total	deu,fra,lat
totál	deu,fra,lat
totem	deu,eng
totiž	ces
tožn	rus
tuž	ces
toužeb	ces
touh	ces
továren	ces
tovar	ces
tovaryš	ces
toxic	lat,ell
trabl	eng,fra,lat
trache	lat,ell
trachom	ell
tracht	lat
traj	deu,lat
trajler	eng,fro
trakc	lat
traktát	lat
tramín	ita
trampolín	deu,ita,deu
tramt	ces
tramvaják	eng
trans	deu,eng,fra,lat
trans-	lat
scend	lat
transkrib	lat
transmis	lat
parent	deu,fra,lat
transvestismus	lat
istor	deu,eng
trapéz	deu,lat,ell
trapn	ces
trapičský	ces
tras	deu,fra,lat
trast	eng,deu
potr	ces
útrat	ces
trát	ces
olišt	ces
travertin	ita,lat
otrava	ces
trč	ces
trdl	ces
trekk	eng,nld
trémist	ces
tremol	ita,lat
tremp	eng
trend	eng,ang
treper	ces
trepk	gml
tresč	rus,isl
tresk	rus,isl
tresť	pol
tretk	ces
tretr	deu
trhovec	ces
trhov	ces
trhav	ces
trhák	ces
trhl	ces
potrhl	ces
tri-	lat,ell
angl	deu,lat
trias	ell
tribut	lat
triceps	lat
triedr	fra,ell
trig	lat
trigon	lat
trichina	lat,ell
trič	fra,fro,deu
trikolor	fra,lat
trilion	lat
trilobit	lat,ell
trimestr	lat
trio	ita,lat
triol	ita
partit	fra,lat
tripl	deu
tript	deu,ell
tristn	deu,fra,lat
triumvir	lat
triviál	deu,fra,lat
trmác	ces
trnit	ces
trofej	deu,fra,lat,ell
trol	eng,fro,lat
trombon	ita,deu
tromb	ell
tropus	lat,ell
trotl	deu
trouba1	ces
trouba2	ces
troud	ces
trouf	ces
trus	ces
trpasl	ces
trpas	ces
trpaslík	ces
trubad	fra,lat
truhlík	gmh
trumpetk	deu,fra,fro,frk
trup	ces
trusk	ces
trust	eng,deu
tryl	deu,ita
trylek	deu,ita
tryskáč	ces
trýzeň	ces
tryzn	pol,chu,orv
třasořitka	ita,deu
třasl	ces
třasák	ces
třemd	ces
třeň	ces
třen	ces
třešn	ces
třešň	ces
třeš	ces
trojí	ces
třídní	ces
třídn	ces
nictv	ces
ídír	ces
třída1	ces
třída2	ita
třím	pol
tří	ces
tříslo1	ces
tříslo2	ces
tříšť	ces
třec	ces
tír	ces
třmín	ces
třmen	ces
třpyt	ces
tub	deu,eng,fra,lat
tuba1	deu,eng,fra,lat
tuba2	lat
tuberkulóz	lat
tuberkul	lat
tuct	deu,gmh,fro,lat
tucet	deu,gmh,fro,lat
tudíž	ces
tud	ces
tuha	ces
ťuh	ces
tuchl	ces
túje	lat,ell
tulení	rus
tuleň	rus
ťulpas	hun
tumor	lat
tumpach	deu,gmh
tůňk	ces
tůň	ces
tuň	deu,lat,ell,sem
tundr	rus,fin
tunik	lat,sem
tupír	deu,fra,fro,deu
tuplák	ces
tupl	ces
turist	deu,fra,lat,fro
túr	deu,fra,lat,fro
turban	deu,tur,pes
turbul	lat
turf	eng
turné	fra
turniket	fra
turnus	deu,lat
tuřín	deu,gmh,lat
tuš1	deu,fra,lat
tuš2	deu
tutl	ces
tuz	ces
tuzér	deu,fra,lat
tvůj	ces
twist	eng
tyčk	ces
tygřic	deu,fra,lat,ell
tygř	deu,fra,lat,ell
tygr	deu,fra,lat,ell
tyk	ces
ty	ces
týk	ces
tykev	ces
tympán	lat,ell
tyrank	lat,ell
tý	ces
týž	ces
u	ces
ú-	ces
ubik	deu,ita,lat
ubož	ces
účetní	ces
nliv	ces
ňovsk	ces
ebn	ces
učed	ces
ed	ces
nau	ces
uk	ces
douk	ces
úd	ces
udát se	ces
deř	ces
didl	ces
udic	ces
uz	ces
uzen	ces
hlák	ces
uhlíř	ces
uhlík	ces
úhl	ces
uhrov	ces
uher	ces
úhon	ces
úhor	ces
úhoř	ces
ušn	ces
uš	ces
ušank	ces
ušák	ces
ušař	ces
ucháč	ces
náuš	ces
ucho	ces
ujec	pol,rus,deu
ulic	ces
ulit	rus
ulti	lat
ultra-	lat
unc	deu,eng,fra,lat
unfair	eng
uni-	lat
unisono	ita,lat
uny	ces
úpěn	ces
úp	ces
píř	ces
pír	ces
úprkem	ces
prk	ces
ragán	spa,fra
uran	deu
urb	lat,gmh
urgent	lat
urput	ces
urputn	ces
seň	ces
sín	ces
ústret	slk
útek	ces
tík	ces
útok	ces
utop	deu,fra,eng
trejch	gmh
útrob	ces
trum	lat
uzanc	fra,lat
uzlík	ces
uzlin	ces
uzel	ces
úžin	ces
žitek	ces
užovk	ces
v	ces
vabank	fra,lat
vábn	ces
vačic	gmh
vač	gmh
váč	gmh
-vádět	ces
vafl	deu,nld
vagabund	deu,fra,frm,lat
vagin	lat
nost	deu,fra,lat
vagonek	deu,eng,dum
vachrlat	deu
vakát	deu,lat
vakc	lat
vakuum	deu,lat
vých	deu
valach	deu
valdhor	deu
valenč	deu,lat
valenc	deu,lat
valch	deu
nával	ces
příval	ces
zával	ces
válk	ces
valor	deu,lat
valoun	rus
vamp	eng
vampýr	srp,deu,fra,eng,ron
vanil	deu,fra,spa,lat
vánoč	ces
Vánoc	ces
ván	ces
vánic	ces
vanou	ces
vantrok	ces
vápenc	ces
vápník	ces
varan	ara
varhany	lat,ell
varieté	fra,lat
vařič	ces
vařečk	ces
á	ces
vášeň	ces
svá	ces
věv	ces
vatr	ces
vazal	deu,gmh,fro,lat
vazba	ces
vazeb	ces
vaze	eng,deu,ell
včelín	ces
včil	deu,eng
vdát se	ces
vdovec	ces
vec	ces
večír	ces
večerk	ces
večern	ces
veče	ces
vedl	ces
vedle	ces
vedr	ces
vědr	ces
vedut	ita,lat
vehemenc	deu,lat
hement	deu,lat
hik	deu,lat
věchýtek	ces
věch	ces
vajíč	ces
vejč	ces
vej	ces
nikolivěk	ces
-věk	ces
vek	deu
vele-	ces
velebn	ces
Vel	ces
ikáš	ces
velo	fra
vem	ces
venek	ces
zven	ces
vendet	ita,lat
věneč	ces
věnec	ces
vener	lat
veneric	lat
ventilek	deu,lat
přov	ces
přín	ces
přovic	ces
vepř	ces
verand	deu,eng
vercajk	deu
verdikt	deu,eng,lat,fro
vermut	deu
vernis	fra
verpán	deu
verst	rus
vers	lat
věrtel	gmh
vervn	fra,fro,lat
verv	fra,fro,lat
verzál	deu,lat
veřejn	ces
-věsit	ces
veslic	ces
vesn	rus,chu
vedoucí	ces
průvodce	ces
průvodčí	ces
převaděč	ces
závodčí	ces
wieść	ces
vestí	ces
vȅsti	ces
vesti	ces
vestibul	deu,fra,lat
všivák	ces
věštb	ces
veta	gmh
větn	ces
veterán	deu,lat
év	ces
větev	ces
vetch	ces
větš	ces
větší	ces
vezd	ces
vezír	tur,ara
vez	tur,ara
přívoz	ces
svéz	ces
vieźć	ces
veztí	ces
věžák	ces
via	deu,eng,lat
vibrafon	lat
vice-	lat
více	ces
viďte	ces
viď	ces
nevidomý	ces
vidin	ces
vigili	lat
vigvam	eng
vích	ces
vichřic	ces
vichr	ces
vikev	gmh,lat
víčk	ces
vík	ces
vikomt	fra,fro,lat
vikslajv	deu
vikýř	gmh
vilk	deu,lat
víl	ces
viln	ces
vinný	ces
vinic	ces
vindr	deu
vinkul	lat
vinař	ces
vinu	ces
vinyl	lat
cellist	ita
virus	lat
věrn	ces
věřící	ces
virgule	lat
uóz	deu,ita,lat
virtuoz	deu,ita,lat
virtuos	deu,ita,lat
virvál	deu
virž	ces
visut	ces
viskozit	lat
višeň	ces
vij	ces
svíj	ces
závi	ces
ital	deu,lat
vitál	deu,lat
vítězn	ces
vítr	ces
vitr	deu,fra,lat
vitrín	deu,fra,lat
vitriol	deu,lat
vivat	lat
vivisekc	lat
vizáž	deu,fra,fro,lat
vizit	deu,fra,eng
vizm	deu
vladyck	ces
vladyk	ces
vlah	ces
vlažn	ces
vláh	ces
vlák	ces
vláseč	ces
vlaš	deu
vyvlát	rus,chu
vlečk	ces
vliv	ces
dlak	ces
vlna1	ces
vlna2	ces
vloč	deu
vločk	deu
vlys	deu
vnadn	ces
vna	ces
vnad	ces
vně	ces
vnitřnosti	lat
vnuč	ces
vnuk	ces
Vodnář	ces
voj1	ces
voj2	ces
-voj	ces
vojen	ces
vojsko	ces
vokal	deu,lat
vokál	deu,lat
volant	lat
svoln	ces
volný	ces
vorv	rus
rvaň	rus
votiv	deu,lat
-vozovat	ces
vrac	ces
vražd	ces
vrah	ces
vrak	deu
vrán	ces
vraš	ces
vrátk	ces
vrátný	ces
vratn	ces
vrhcáby	gmh,lat
vrhač	deu
přívrž	deu
vrhlík	deu
vrchní	ces
vrk	ces
vrkoč	ces
vrn	ces
vrst	ces
evnic	ces
vrtn	ces
vrták	ces
vrtk	ces
vrtul	ces
vřav	ces
vříd	ces
vřešť	ces
eten	ces
vřet	ces
-vřít	ces
střeb	ces
však	ces
všecko	ces
vším	ces
všud	ces
vteř	ces
vteřin	ces
vti	ces
vůbec	ces
vůči	ces
covsk	ces
vulgarit	deu,lat
vulg	deu,lat
vulkanick	lat
vulkán	lat
vulv	lat
voň	ces
vůn	ces
vuřt	deu
vůz	ces
vy	ces
wy-	ces
vy-	ces
vydr	ces
heň	ces
hřez	ces
-vykat	ces
ňat	ces
pouk	ces
vejr	ces
výr	ces
vysočin	ces
vys	ces
výt	ces
záb	ces
vyžle	gmh
vz-	ces
vzdor	ces
vze	ces
vznět	ces
pour	ces
vždy	ces
vždyť	eng
waltz	eng,deu
west	eng,lat,ell
whisky	eng
whist	eng
wind	eng
wolfram	deu,gmh
xantip	ell
xerox	eng,ell
xylo	ell
xy	ell
lol	ell
yard	eng,ang
yetti	eng
ypsilon	ell
yzop	lat,ell,heb
z	ces
za	ces
bradl	ces
zábs	ces
začít	ces
záď	ces
zad	ces
zád	ces
hálk	ces
hradn	ces
záh	ces
zajíč	ces
zaječ	ces
zajíc	ces
kamp	ces
zákoník	ces
krist	lat
zákrs	ces
zakrs	ces
zámek1	ces
mec	deu
zámek2	deu
mož	ces
záplat	ces
záprt	ces
roveň	ces
zarput	ces
zarputi	ces
rubeň	ces
řiv	ces
zářič	ces
zař	ces
zářij	ces
zase	ces
šantroč	ces
záškrt	ces
zášť	ces
záštit	ces
trac	ces
věť	rus
vit	ces
závod1	ces
závod2	rus
vrať	ces
zbl	ces
zbož	ces
brkl	ces
zbrk	ces
broc	ces
zdali	ces
zda	ces
zdát se	ces
zdráh	ces
zdroj	pol
zebř	por
zebr	por
zeb	deu,fra
zíd	ces
zděn	ces
zeď	ces
fír	fra,ell
zejména	ces
zeleň	ces
zeln	ces
zelň	ces
zel	ces
zemin	ces
země	lat
zenit	deu,ita,fra,ara
zerav	ces
zej	ces
zet	ces
zeť	ces
zeugm	ell
vloun	ces
zevl	ces
vn	ces
vrub	ces
hrz	ces
hurt	gmh,fro
hýr	ces
ozim	ces
zima	ces
stráz	ces
zinek	deu
zip	eng
zišt	ces
získ	ces
zítr	ces
krouš	ces
zlatý	ces
zlatn	ces
zlob	ces
zlí	ces
mátoř	lat
zmetek	ces
znak1	ces
znak2	ces
známý	ces
seznam	ces
znoj	ces
odiak	lat,ell
zout se	ces
zout 	ces
zpát	ces
pěč	ces
zpět	ces
pěvn	ces
pyt	ces
zrádn	ces
zral	ces
zra	ces
zrál	ces
růdn	ces
zrzek	ces
zrzk	ces
zrz	ces
ejm	ces
zřídl	ces
zoub	ces
zubr	ces
zunk	ces
pozůstalý	ces
zev	ces
zvěn	ces
zýv	ces
zvát	ces
zvěr	ces
zvíc	ces
zvonek	ces
sezvánět	ces
zván	ces
↑kéž	ces
↑tož	ces
-ž	ces
žáb	ces
žaber	rus
žábry	rus
žáh	ces
žáč	lat,ell
žačk	lat,ell
žákyn	lat,ell
žactv	lat,ell
žákov	lat,ell
žák	lat,ell
žaket	fra
obžalovaný	ces
žaludsk	ces
žaludeč	ces
žaludek	ces
žaluz	deu,fra,ita,lat,ell
žandarm	deu,fra
žargon	fra
žatv	slk
že	ces
žeber	ces
žehl	ces
žehr	ces
žejdl	deu,gmh,lat
želíz	ces
žň	ces
žeň	ces
ženist	fra,lat
ženij	fra,lat
žent	ces
žerď	ces
žernov	ces
žertv	rus,chu
žerv	fra
žerz	eng
žesť	rus
žestě	rus
žeton	fra,lat
žezl	ces
žežulk	ces
žhoucí	ces
žih	ces
žíh	ces
žilk	ces
žíl	ces
žilet	fra
žinant	deu,fra,fro,frk
žinč	ces
žínk	ces
žir	deu,ita,lat,ell
žízeň	srp
žížal	ces
žláb	ces
žlab	ces
žlun	ces
žluť	ces
žluťásek	ces
žloutk	ces
žluv	ces
žmolek	ces
žmol	ces
žmoul	ces
žnec	ces
žnečk	ces
žn	ces
žok	gmh
žokej	eng
žoldák	gmh,fro,lat
žoldáck	gmh,fro,lat
žolík	eng
žongl	deu,fra,fro,lat
žorž	fra
žoviál	deu,fra,ita,lat
žra	pol
žralok	pol
žrout	ces
žran	ces
vyžírka	ces
žrec	rus
žump	deu
župan	ita,ara
žurnál	fra,lat
žužu	fra
žv	ces
žvástat	ces
žvást	ces
žvatlav	ces
žvatl	ces
